32,1,32,1,1,5,22,1056,100,1183
32,1,32,1,1,5,22,1055,73,1155
32,1,32,1,1,6,22,1052,81,1161
32,1,32,1,1,9,33,1055,110,1207
32,1,32,1,1,5,23,1053,89,1170
32,1,32,1,1,5,23,1052,82,1162
32,1,32,1,1,8,23,1051,79,1161
32,1,32,1,1,8,23,1055,89,1175
32,1,32,1,1,5,23,1051,75,1154
32,1,32,1,1,5,22,1052,72,1151
32,2,16,1,1,5,21,1052,76,1154
32,2,16,1,1,6,22,1052,74,1154
32,2,16,1,1,6,23,1053,123,1205
32,2,16,1,1,8,28,1057,108,1201
32,2,16,1,1,6,22,1053,81,1162
32,2,16,1,1,6,23,1058,207,1294
32,2,16,1,1,10,29,1058,98,1195
32,2,16,1,1,6,25,1061,93,1185
32,2,16,1,1,5,23,1090,78,1196
32,2,16,1,1,6,22,1052,78,1158
32,4,8,1,1,6,22,1053,77,1158
32,4,8,1,1,7,21,1052,74,1154
32,4,8,1,1,5,22,1053,73,1153
32,4,8,1,1,5,22,1056,74,1157
32,4,8,1,1,5,21,1053,84,1163
32,4,8,1,1,6,24,1056,120,1206
32,4,8,1,1,6,27,1055,95,1183
32,4,8,1,1,5,22,1052,89,1168
32,4,8,1,1,5,24,1054,80,1163
32,4,8,1,1,6,23,1052,76,1157
32,8,4,1,1,5,22,1310,75,1412
32,8,4,1,1,11,34,1326,316,1687
32,8,4,1,1,6,24,1312,94,1436
32,8,4,1,1,5,22,1309,77,1413
32,8,4,1,1,5,23,1309,84,1421
32,8,4,1,1,6,22,1309,77,1414
32,8,4,1,1,5,21,1309,75,1410
32,8,4,1,1,5,22,1310,74,1411
32,8,4,1,1,6,25,1317,199,1547
32,8,4,1,1,6,25,1315,122,1468
32,16,2,1,1,6,22,1311,83,1422
32,16,2,1,1,5,22,1310,75,1412
32,16,2,1,1,5,21,1309,123,1458
32,16,2,1,1,5,22,1310,74,1411
32,16,2,1,1,6,23,1310,81,1420
32,16,2,1,1,6,23,1310,81,1420
32,16,2,1,1,5,22,1312,74,1413
32,16,2,1,1,6,27,1317,124,1474
32,16,2,1,1,5,22,1310,90,1427
32,16,2,1,1,6,23,1317,79,1425
32,32,1,1,1,6,22,1312,78,1418
32,32,1,1,1,6,22,1312,75,1415
32,32,1,1,1,5,22,1313,74,1414
32,32,1,1,1,5,22,1311,73,1411
32,32,1,1,1,6,25,1319,161,1511
32,32,1,1,1,6,25,1319,113,1463
32,32,1,1,1,6,24,1314,101,1445
32,32,1,1,1,5,23,1313,81,1422
32,32,1,1,1,5,22,1316,78,1421
32,32,1,1,1,6,23,1312,76,1417
32,1,64,1,1,5,23,1311,78,1417
32,1,64,1,1,5,22,1362,172,1561
32,1,64,1,1,6,33,1374,117,1530
32,1,64,1,1,8,25,1362,108,1503
32,1,64,1,1,5,22,1360,83,1470
32,1,64,1,1,5,22,1360,75,1462
32,1,64,1,1,5,22,1359,72,1458
32,1,64,1,1,5,22,1359,75,1461
32,1,64,1,1,6,22,1360,73,1461
32,1,64,1,1,5,21,1359,77,1462
32,2,32,1,1,6,24,1376,151,1557
32,2,32,1,1,6,25,1361,91,1483
32,2,32,1,1,6,24,1360,78,1468
32,2,32,1,1,5,22,1359,75,1461
32,2,32,1,1,5,22,1359,73,1459
32,2,32,1,1,6,22,1360,81,1469
32,2,32,1,1,6,23,1361,78,1468
32,2,32,1,1,7,34,1376,204,1621
32,2,32,1,1,5,23,1361,96,1485
32,2,32,1,1,5,22,1360,78,1465
32,4,16,1,1,6,23,1363,137,1529
32,4,16,1,1,6,23,1363,135,1527
32,4,16,1,1,6,23,1361,91,1481
32,4,16,1,1,5,25,1363,84,1477
32,4,16,1,1,5,22,1361,81,1469
32,4,16,1,1,6,22,1360,76,1464
32,4,16,1,1,5,22,1360,74,1461
32,4,16,1,1,5,23,1374,176,1578
32,4,16,1,1,6,26,1363,121,1516
32,4,16,1,1,6,22,1360,80,1468
32,8,8,1,1,5,22,1360,73,1460
32,8,8,1,1,6,23,1368,200,1597
32,8,8,1,1,8,27,1362,123,1520
32,8,8,1,1,6,24,1361,92,1483
32,8,8,1,1,6,23,1360,78,1467
32,8,8,1,1,5,22,1359,77,1463
32,8,8,1,1,6,22,1360,74,1462
32,8,8,1,1,6,22,1359,76,1463
32,8,8,1,1,10,34,1366,134,1544
32,8,8,1,1,8,24,1361,81,1474
32,16,4,1,1,6,23,1361,82,1472
32,16,4,1,1,5,23,1360,74,1462
32,16,4,1,1,5,22,1360,77,1464
32,16,4,1,1,5,22,1359,73,1459
32,16,4,1,1,5,22,1360,74,1461
32,16,4,1,1,5,24,1366,155,1550
32,16,4,1,1,6,24,1361,104,1495
32,16,4,1,1,5,22,1364,78,1469
32,16,4,1,1,6,23,1361,85,1475
32,16,4,1,1,7,30,1367,167,1571
32,32,2,1,1,6,25,1363,92,1486
32,32,2,1,1,6,22,1360,77,1465
32,32,2,1,1,5,22,1360,77,1464
32,32,2,1,1,5,22,1361,74,1462
32,32,2,1,1,5,22,1360,73,1460
32,32,2,1,1,5,22,1360,74,1461
32,32,2,1,1,6,24,1363,143,1536
32,32,2,1,1,6,23,1360,83,1472
32,32,2,1,1,9,23,1361,82,1475
32,32,2,1,1,5,22,1360,81,1468
32,64,1,1,1,8,24,1366,74,1472
32,64,1,1,1,5,22,1362,75,1464
32,64,1,1,1,6,23,1364,105,1498
32,64,1,1,1,7,24,1364,82,1477
32,64,1,1,1,6,23,1363,109,1501
32,64,1,1,1,5,23,1363,76,1467
32,64,1,1,1,6,22,1362,75,1465
32,64,1,1,1,5,22,1362,79,1468
32,64,1,1,1,6,22,1363,277,1668
32,64,1,1,1,6,24,1364,100,1494
32,1,128,1,1,5,22,1359,75,1461
32,1,128,1,1,5,22,1360,78,1465
32,1,128,1,1,5,22,1360,73,1460
32,1,128,1,1,5,21,1360,72,1458
32,1,128,1,1,6,22,1360,72,1460
32,1,128,1,1,5,22,1359,73,1459
32,1,128,1,1,5,23,1363,74,1465
32,1,128,1,1,5,21,1360,74,1460
32,1,128,1,1,5,22,1359,77,1463
32,1,128,1,1,5,22,1360,74,1461
32,2,64,1,1,5,23,1360,74,1462
32,2,64,1,1,6,22,1361,111,1500
32,2,64,1,1,8,29,1362,92,1491
32,2,64,1,1,6,21,1360,73,1460
32,2,64,1,1,5,22,1360,73,1460
32,2,64,1,1,6,22,1359,73,1460
32,2,64,1,1,5,22,1360,73,1460
32,2,64,1,1,5,23,1360,88,1476
32,2,64,1,1,5,22,1360,73,1460
32,2,64,1,1,6,23,1360,96,1485
32,4,32,1,1,6,23,1361,81,1471
32,4,32,1,1,5,23,1361,79,1468
32,4,32,1,1,6,22,1361,76,1465
32,4,32,1,1,5,22,1360,75,1462
32,4,32,1,1,5,22,1361,76,1464
32,4,32,1,1,5,22,1361,122,1510
32,4,32,1,1,6,22,1361,96,1485
32,4,32,1,1,6,22,1361,87,1476
32,4,32,1,1,8,100,1362,90,1560
32,4,32,1,1,5,24,1362,78,1469
32,8,16,1,1,5,23,1361,79,1468
32,8,16,1,1,6,22,1359,78,1465
32,8,16,1,1,5,22,1359,75,1461
32,8,16,1,1,5,22,1360,72,1459
32,8,16,1,1,5,22,1360,79,1466
32,8,16,1,1,5,22,1361,74,1462
32,8,16,1,1,5,22,1366,80,1473
32,8,16,1,1,5,22,1360,82,1469
32,8,16,1,1,7,32,1380,197,1616
32,8,16,1,1,6,22,1361,100,1489
32,16,8,1,1,6,22,1361,78,1467
32,16,8,1,1,5,22,1360,76,1463
32,16,8,1,1,5,22,1361,77,1465
32,16,8,1,1,5,22,1359,74,1460
32,16,8,1,1,5,22,1360,75,1462
32,16,8,1,1,5,22,1359,74,1460
32,16,8,1,1,5,22,1359,73,1459
32,16,8,1,1,7,23,1362,122,1514
32,16,8,1,1,5,24,1363,122,1514
32,16,8,1,1,6,23,1361,80,1470
32,32,4,1,1,6,21,1359,74,1460
32,32,4,1,1,8,27,1366,122,1523
32,32,4,1,1,6,31,1365,104,1506
32,32,4,1,1,5,23,1361,81,1470
32,32,4,1,1,6,23,1360,80,1469
32,32,4,1,1,5,24,1361,78,1468
32,32,4,1,1,5,22,1359,77,1463
32,32,4,1,1,5,22,1360,72,1459
32,32,4,1,1,5,23,1360,81,1469
32,32,4,1,1,8,25,1366,131,1530
32,64,2,1,1,6,24,1361,83,1474
32,64,2,1,1,6,23,1361,99,1489
32,64,2,1,1,6,23,1360,75,1464
32,64,2,1,1,5,22,1360,75,1462
32,64,2,1,1,6,21,1360,73,1460
32,64,2,1,1,5,21,1365,128,1519
32,64,2,1,1,6,25,1364,133,1528
32,64,2,1,1,6,24,1363,103,1496
32,64,2,1,1,5,23,1360,84,1472
32,64,2,1,1,5,23,1360,77,1465
32,128,1,1,1,5,23,1362,75,1465
32,128,1,1,1,5,22,1363,107,1497
32,128,1,1,1,6,30,1372,155,1563
32,128,1,1,1,6,24,1364,81,1475
32,128,1,1,1,5,23,1363,84,1475
32,128,1,1,1,5,22,1362,78,1467
32,128,1,1,1,6,22,1365,75,1468
32,128,1,1,1,6,23,1363,77,1469
32,128,1,1,1,6,23,1363,79,1471
32,128,1,1,1,9,25,1373,216,1623
32,1,256,1,1,6,25,1364,117,1512
32,1,256,1,1,6,24,1360,100,1490
32,1,256,1,1,5,22,1361,79,1467
32,1,256,1,1,5,22,1360,75,1462
32,1,256,1,1,6,21,1363,167,1557
32,1,256,1,1,5,23,1360,75,1463
32,1,256,1,1,5,23,1360,75,1463
32,1,256,1,1,6,23,1361,74,1464
32,1,256,1,1,6,22,1361,77,1466
32,1,256,1,1,5,22,1361,78,1466
32,2,128,1,1,6,21,1364,74,1465
32,2,128,1,1,5,22,1363,258,1648
32,2,128,1,1,6,23,1360,93,1482
32,2,128,1,1,6,23,1360,80,1469
32,2,128,1,1,6,23,1361,77,1467
32,2,128,1,1,5,23,1362,120,1510
32,2,128,1,1,9,25,1364,121,1519
32,2,128,1,1,5,23,1361,106,1495
32,2,128,1,1,6,22,1360,78,1466
32,2,128,1,1,5,23,1360,77,1465
32,4,64,1,1,5,22,1359,75,1461
32,4,64,1,1,5,22,1360,73,1460
32,4,64,1,1,5,21,1360,90,1476
32,4,64,1,1,6,22,1360,76,1464
32,4,64,1,1,5,22,1362,109,1498
32,4,64,1,1,6,24,1362,104,1496
32,4,64,1,1,8,23,1360,82,1473
32,4,64,1,1,6,22,1364,76,1468
32,4,64,1,1,5,22,1360,74,1461
32,4,64,1,1,5,21,1360,75,1461
32,8,32,1,1,6,34,1370,138,1548
32,8,32,1,1,6,29,1371,116,1522
32,8,32,1,1,6,23,1361,80,1470
32,8,32,1,1,6,24,1363,79,1472
32,8,32,1,1,5,22,1360,80,1467
32,8,32,1,1,5,22,1360,72,1459
32,8,32,1,1,6,22,1360,77,1465
32,8,32,1,1,5,22,1360,75,1462
32,8,32,1,1,5,22,1360,76,1463
32,8,32,1,1,5,22,1361,94,1482
32,16,16,1,1,7,24,1361,83,1475
32,16,16,1,1,5,23,1360,80,1468
32,16,16,1,1,6,22,1360,77,1465
32,16,16,1,1,5,22,1360,73,1460
32,16,16,1,1,5,22,1361,73,1461
32,16,16,1,1,6,21,1360,77,1464
32,16,16,1,1,6,24,1366,138,1534
32,16,16,1,1,6,25,1364,113,1508
32,16,16,1,1,5,22,1364,94,1485
32,16,16,1,1,5,22,1361,78,1466
32,32,8,1,1,6,22,1361,75,1464
32,32,8,1,1,5,22,1359,75,1461
32,32,8,1,1,5,23,1362,122,1512
32,32,8,1,1,8,30,1364,135,1537
32,32,8,1,1,8,26,1363,90,1487
32,32,8,1,1,6,23,1361,77,1467
32,32,8,1,1,6,22,1361,75,1464
32,32,8,1,1,7,22,1360,75,1464
32,32,8,1,1,5,23,1360,118,1506
32,32,8,1,1,6,25,1363,188,1582
32,64,4,1,1,5,22,1361,89,1477
32,64,4,1,1,5,22,1360,72,1459
32,64,4,1,1,6,22,1360,74,1462
32,64,4,1,1,5,23,1361,79,1468
32,64,4,1,1,8,25,1364,140,1537
32,64,4,1,1,6,25,1361,105,1497
32,64,4,1,1,6,23,1361,81,1471
32,64,4,1,1,5,22,1361,77,1465
32,64,4,1,1,5,22,1360,72,1459
32,64,4,1,1,6,22,1365,75,1468
32,128,2,1,1,6,22,1360,75,1463
32,128,2,1,1,5,22,1360,122,1509
32,128,2,1,1,6,25,1366,154,1551
32,128,2,1,1,6,23,1363,97,1489
32,128,2,1,1,6,24,1362,81,1473
32,128,2,1,1,5,21,1360,77,1463
32,128,2,1,1,5,22,1361,74,1462
32,128,2,1,1,5,22,1360,76,1463
32,128,2,1,1,5,22,1360,74,1461
32,128,2,1,1,5,22,1360,74,1461
32,256,1,1,1,8,35,1372,156,1571
32,256,1,1,1,6,23,1364,108,1501
32,256,1,1,1,7,27,1367,97,1498
32,256,1,1,1,6,28,1371,158,1563
32,256,1,1,1,6,26,1367,112,1511
32,256,1,1,1,6,24,1364,103,1497
32,256,1,1,1,6,25,1364,82,1477
32,256,1,1,1,6,22,1362,74,1464
32,256,1,1,1,6,22,1363,78,1469
32,256,1,1,1,7,29,1368,135,1539
64,1,32,2,1,11,22,2442,78,2553
64,1,32,2,1,11,22,2442,73,2548
64,1,32,2,1,18,50,2457,195,2720
64,1,32,2,1,21,32,2457,255,2765
64,1,32,2,1,11,22,2444,83,2560
64,1,32,2,1,11,22,2442,78,2553
64,1,32,2,1,11,22,2443,74,2550
64,1,32,2,1,11,21,2443,77,2552
64,1,32,2,1,11,21,2447,141,2620
64,1,32,2,1,13,39,2484,141,2677
64,2,16,2,1,11,23,2441,89,2564
64,2,16,2,1,26,23,2438,79,2566
64,2,16,2,1,11,21,2438,75,2545
64,2,16,2,1,16,28,2444,112,2600
64,2,16,2,1,11,23,2448,139,2621
64,2,16,2,1,17,24,2441,94,2576
64,2,16,2,1,11,24,2440,81,2556
64,2,16,2,1,16,23,2439,77,2555
64,2,16,2,1,11,21,2438,73,2543
64,2,16,2,1,11,22,2441,85,2559
64,4,8,2,1,16,27,2443,118,2604
64,4,8,2,1,11,23,2440,83,2557
64,4,8,2,1,11,21,2439,75,2546
64,4,8,2,1,11,20,2439,88,2558
64,4,8,2,1,11,21,2440,76,2548
64,4,8,2,1,11,22,2440,88,2561
64,4,8,2,1,11,23,2439,98,2571
64,4,8,2,1,11,24,2440,85,2560
64,4,8,2,1,11,22,2440,81,2554
64,4,8,2,1,11,22,2444,78,2555
64,8,4,2,1,11,21,2439,74,2545
64,8,4,2,1,11,21,2443,134,2609
64,8,4,2,1,11,24,2442,114,2591
64,8,4,2,1,11,21,2439,75,2546
64,8,4,2,1,11,23,2440,77,2551
64,8,4,2,1,11,21,2442,74,2548
64,8,4,2,1,11,22,2438,76,2547
64,8,4,2,1,11,22,2439,75,2547
64,8,4,2,1,11,22,2439,78,2550
64,8,4,2,1,11,23,2442,137,2613
64,16,2,2,1,11,22,2440,82,2555
64,16,2,2,1,11,24,2440,79,2554
64,16,2,2,1,11,22,2439,76,2548
64,16,2,2,1,11,22,2440,107,2580
64,16,2,2,1,11,24,2444,136,2615
64,16,2,2,1,11,24,2440,83,2558
64,16,2,2,1,11,22,2438,77,2548
64,16,2,2,1,11,22,2439,75,2547
64,16,2,2,1,11,22,2440,75,2548
64,16,2,2,1,11,21,2439,83,2554
64,32,1,2,1,13,22,2448,159,2642
64,32,1,2,1,11,27,2451,143,2632
64,32,1,2,1,16,23,2445,84,2568
64,32,1,2,1,11,21,2444,79,2555
64,32,1,2,1,11,22,2445,73,2551
64,32,1,2,1,16,23,2449,165,2653
64,32,1,2,1,11,25,2445,92,2573
64,32,1,2,1,11,23,2446,80,2560
64,32,1,2,1,11,21,2445,76,2553
64,32,1,2,1,11,22,2444,73,2550
64,1,64,1,1,11,23,2439,122,2595
64,1,64,1,1,11,22,2439,105,2577
64,1,64,1,1,11,22,2438,79,2550
64,1,64,1,1,11,22,2438,77,2548
64,1,64,1,1,11,22,2438,75,2546
64,1,64,1,1,11,22,2437,72,2542
64,1,64,1,1,11,22,2438,74,2545
64,1,64,1,1,11,23,2443,279,2756
64,1,64,1,1,11,24,2441,124,2600
64,1,64,1,1,11,23,2442,93,2569
64,2,32,1,1,11,21,2438,77,2547
64,2,32,1,1,11,21,2438,79,2549
64,2,32,1,1,11,22,2437,73,2543
64,2,32,1,1,11,22,2438,83,2554
64,2,32,1,1,11,25,2441,240,2717
64,2,32,1,1,11,24,2441,107,2583
64,2,32,1,1,11,22,2438,76,2547
64,2,32,1,1,11,22,2437,74,2544
64,2,32,1,1,11,22,2438,76,2547
64,2,32,1,1,11,22,2438,75,2546
64,4,16,1,1,11,22,2440,108,2581
64,4,16,1,1,11,36,2445,126,2618
64,4,16,1,1,11,23,2438,85,2557
64,4,16,1,1,11,22,2441,77,2551
64,4,16,1,1,11,21,2438,77,2547
64,4,16,1,1,12,22,2437,74,2545
64,4,16,1,1,11,22,2437,74,2544
64,4,16,1,1,16,23,2441,76,2556
64,4,16,1,1,11,24,2438,91,2564
64,4,16,1,1,11,22,2438,79,2550
64,8,8,1,1,11,22,2438,76,2547
64,8,8,1,1,11,26,2446,133,2616
64,8,8,1,1,17,34,2445,129,2625
64,8,8,1,1,11,24,2438,78,2551
64,8,8,1,1,11,23,2438,78,2550
64,8,8,1,1,11,22,2438,75,2546
64,8,8,1,1,11,22,2438,74,2545
64,8,8,1,1,11,22,2438,83,2554
64,8,8,1,1,11,22,2438,98,2569
64,8,8,1,1,11,23,2438,91,2563
64,16,4,1,1,11,22,2438,78,2549
64,16,4,1,1,11,22,2438,79,2550
64,16,4,1,1,11,22,2438,77,2548
64,16,4,1,1,11,22,2437,84,2554
64,16,4,1,1,11,23,2440,118,2592
64,16,4,1,1,11,22,2438,87,2558
64,16,4,1,1,11,21,2440,77,2549
64,16,4,1,1,11,22,2438,78,2549
64,16,4,1,1,11,22,2438,80,2551
64,16,4,1,1,11,22,2438,73,2544
64,32,2,1,1,11,22,2453,175,2661
64,32,2,1,1,11,23,2440,119,2593
64,32,2,1,1,11,21,2437,75,2544
64,32,2,1,1,11,22,2438,82,2553
64,32,2,1,1,11,22,2437,78,2548
64,32,2,1,1,11,26,2445,171,2653
64,32,2,1,1,11,23,2438,88,2560
64,32,2,1,1,11,24,2441,83,2559
64,32,2,1,1,11,23,2441,78,2553
64,32,2,1,1,11,22,2438,75,2546
64,64,1,1,1,11,21,2442,74,2548
64,64,1,1,1,11,22,2442,75,2550
64,64,1,1,1,17,26,2451,155,2649
64,64,1,1,1,16,27,2444,125,2612
64,64,1,1,1,11,23,2444,86,2564
64,64,1,1,1,11,22,2443,83,2559
64,64,1,1,1,11,22,2443,93,2569
64,64,1,1,1,11,23,2445,152,2631
64,64,1,1,1,11,24,2442,98,2575
64,64,1,1,1,11,23,2444,101,2579
64,1,128,1,1,11,22,2438,118,2589
64,1,128,1,1,14,31,2444,115,2604
64,1,128,1,1,11,22,2438,79,2550
64,1,128,1,1,13,32,2448,190,2683
64,1,128,1,1,13,24,2440,108,2585
64,1,128,1,1,11,23,2441,116,2591
64,1,128,1,1,17,26,2442,94,2579
64,1,128,1,1,14,29,2445,152,2640
64,1,128,1,1,15,29,2444,147,2635
64,1,128,1,1,11,23,2438,98,2570
64,2,64,1,1,11,22,2438,77,2548
64,2,64,1,1,11,22,2437,83,2553
64,2,64,1,1,11,23,2441,75,2550
64,2,64,1,1,11,21,2438,75,2545
64,2,64,1,1,18,29,2442,125,2614
64,2,64,1,1,11,24,2441,193,2669
64,2,64,1,1,11,32,2447,142,2632
64,2,64,1,1,11,22,2438,83,2554
64,2,64,1,1,11,22,2437,77,2547
64,2,64,1,1,11,21,2437,74,2543
64,4,32,1,1,11,22,2437,76,2546
64,4,32,1,1,11,22,2437,75,2545
64,4,32,1,1,11,22,2438,84,2555
64,4,32,1,1,11,22,2443,220,2696
64,4,32,1,1,13,28,2445,144,2630
64,4,32,1,1,11,23,2439,77,2550
64,4,32,1,1,11,22,2437,74,2544
64,4,32,1,1,11,21,2438,76,2546
64,4,32,1,1,12,21,2437,78,2548
64,4,32,1,1,11,21,2443,191,2666
64,8,16,1,1,14,43,2458,139,2654
64,8,16,1,1,11,21,2441,81,2554
64,8,16,1,1,11,22,2437,75,2545
64,8,16,1,1,11,21,2437,77,2546
64,8,16,1,1,11,22,2438,110,2581
64,8,16,1,1,14,24,2441,138,2617
64,8,16,1,1,11,22,2437,74,2544
64,8,16,1,1,11,22,2437,77,2547
64,8,16,1,1,11,22,2443,252,2728
64,8,16,1,1,16,24,2445,129,2614
64,16,8,1,1,11,22,2438,76,2547
64,16,8,1,1,11,22,2439,137,2609
64,16,8,1,1,11,23,2441,123,2598
64,16,8,1,1,11,22,2438,80,2551
64,16,8,1,1,23,22,2437,77,2559
64,16,8,1,1,11,22,2439,74,2546
64,16,8,1,1,11,22,2437,75,2545
64,16,8,1,1,11,21,2438,211,2681
64,16,8,1,1,11,23,2438,77,2549
64,16,8,1,1,16,22,2438,83,2559
64,32,4,1,1,11,22,2437,75,2545
64,32,4,1,1,11,26,2441,139,2617
64,32,4,1,1,11,23,2440,131,2605
64,32,4,1,1,11,24,2438,106,2579
64,32,4,1,1,19,27,2440,102,2588
64,32,4,1,1,11,22,2437,78,2548
64,32,4,1,1,11,23,2440,125,2599
64,32,4,1,1,11,22,2438,78,2549
64,32,4,1,1,11,22,2437,77,2547
64,32,4,1,1,11,22,2437,76,2546
64,64,2,1,1,11,33,2460,73,2577
64,64,2,1,1,11,22,2438,94,2565
64,64,2,1,1,11,23,2440,153,2627
64,64,2,1,1,11,22,2441,80,2554
64,64,2,1,1,11,23,2440,82,2556
64,64,2,1,1,11,22,2440,76,2549
64,64,2,1,1,11,22,2447,76,2556
64,64,2,1,1,11,21,2437,73,2542
64,64,2,1,1,10,21,2441,241,2713
64,64,2,1,1,12,28,2444,124,2608
64,128,1,1,1,11,22,2442,81,2556
64,128,1,1,1,11,23,2441,77,2552
64,128,1,1,1,11,21,2442,78,2552
64,128,1,1,1,11,22,2442,77,2552
64,128,1,1,1,11,22,2442,74,2549
64,128,1,1,1,11,22,2447,333,2813
64,128,1,1,1,11,24,2445,121,2601
64,128,1,1,1,11,23,2442,78,2554
64,128,1,1,1,11,22,2441,76,2550
64,128,1,1,1,11,22,2441,75,2549
64,1,256,1,1,11,21,2436,76,2544
64,1,256,1,1,11,22,2444,165,2642
64,1,256,1,1,21,31,2444,172,2668
64,1,256,1,1,11,22,2437,82,2552
64,1,256,1,1,15,59,2439,81,2594
64,1,256,1,1,11,25,2462,213,2711
64,1,256,1,1,11,23,2441,125,2600
64,1,256,1,1,11,22,2437,75,2545
64,1,256,1,1,11,22,2441,78,2552
64,1,256,1,1,11,22,2437,76,2546
64,2,128,1,1,11,22,2437,76,2546
64,2,128,1,1,11,20,2439,139,2609
64,2,128,1,1,11,23,2442,165,2641
64,2,128,1,1,11,24,2441,107,2583
64,2,128,1,1,11,22,2438,78,2549
64,2,128,1,1,11,21,2437,79,2548
64,2,128,1,1,11,22,2437,75,2545
64,2,128,1,1,11,23,2439,155,2628
64,2,128,1,1,17,24,2439,91,2571
64,2,128,1,1,11,22,2436,79,2548
64,4,64,1,1,11,21,2437,74,2543
64,4,64,1,1,11,23,2441,183,2658
64,4,64,1,1,11,24,2439,118,2592
64,4,64,1,1,11,23,2440,79,2553
64,4,64,1,1,11,21,2442,86,2560
64,4,64,1,1,11,22,2437,76,2546
64,4,64,1,1,11,22,2442,88,2563
64,4,64,1,1,11,24,2447,139,2621
64,4,64,1,1,18,30,2441,128,2617
64,4,64,1,1,11,23,2440,89,2563
64,8,32,1,1,11,21,2437,78,2547
64,8,32,1,1,11,24,2443,161,2639
64,8,32,1,1,11,22,2439,126,2598
64,8,32,1,1,11,21,2439,78,2549
64,8,32,1,1,11,22,2438,77,2548
64,8,32,1,1,11,22,2438,98,2569
64,8,32,1,1,11,26,2460,148,2645
64,8,32,1,1,11,25,2442,136,2614
64,8,32,1,1,11,23,2439,104,2577
64,8,32,1,1,11,22,2438,84,2555
64,16,16,1,1,11,22,2440,74,2547
64,16,16,1,1,11,22,2438,94,2565
64,16,16,1,1,11,21,2440,191,2663
64,16,16,1,1,16,23,2441,184,2664
64,16,16,1,1,11,22,2439,76,2548
64,16,16,1,1,11,23,2438,80,2552
64,16,16,1,1,11,23,2437,83,2554
64,16,16,1,1,11,22,2437,88,2558
64,16,16,1,1,11,22,2440,173,2646
64,16,16,1,1,33,82,2463,162,2740
64,32,8,1,1,11,24,2443,112,2590
64,32,8,1,1,11,23,2437,80,2551
64,32,8,1,1,11,22,2437,79,2549
64,32,8,1,1,11,22,2443,129,2605
64,32,8,1,1,32,27,2460,136,2655
64,32,8,1,1,11,22,2437,88,2558
64,32,8,1,1,11,24,2437,81,2553
64,32,8,1,1,11,22,2437,83,2553
64,32,8,1,1,11,22,2437,75,2545
64,32,8,1,1,11,22,2437,81,2551
64,64,4,1,1,12,27,2441,145,2625
64,64,4,1,1,11,23,2438,83,2555
64,64,4,1,1,11,23,2438,78,2550
64,64,4,1,1,11,23,2437,74,2545
64,64,4,1,1,11,22,2437,76,2546
64,64,4,1,1,11,22,2442,176,2651
64,64,4,1,1,17,26,2441,114,2598
64,64,4,1,1,11,22,2437,82,2552
64,64,4,1,1,11,22,2437,84,2554
64,64,4,1,1,11,21,2438,76,2546
64,128,2,1,1,11,22,2437,75,2545
64,128,2,1,1,11,22,2437,82,2552
64,128,2,1,1,13,31,2448,138,2630
64,128,2,1,1,11,23,2441,140,2615
64,128,2,1,1,11,22,2437,76,2546
64,128,2,1,1,11,22,2437,74,2544
64,128,2,1,1,11,22,2437,76,2546
64,128,2,1,1,11,22,2438,82,2553
64,128,2,1,1,11,21,2443,225,2700
64,128,2,1,1,11,26,2445,160,2642
64,256,1,1,1,11,24,2445,104,2584
64,256,1,1,1,11,22,2441,79,2553
64,256,1,1,1,11,23,2441,76,2551
64,256,1,1,1,11,22,2442,73,2548
64,256,1,1,1,11,22,2442,75,2550
64,256,1,1,1,11,22,2446,184,2663
64,256,1,1,1,16,36,2449,174,2675
64,256,1,1,1,11,23,2444,107,2585
64,256,1,1,1,11,22,2442,76,2551
64,256,1,1,1,11,22,2441,74,2548
128,1,32,2,2,21,22,4650,117,4810
128,1,32,2,2,33,28,4654,135,4850
128,1,32,2,2,21,22,4650,88,4781
128,1,32,2,2,22,22,4653,168,4865
128,1,32,2,2,32,47,4688,148,4915
128,1,32,2,2,21,22,4649,84,4776
128,1,32,2,2,21,22,4650,76,4769
128,1,32,2,2,22,24,4650,95,4791
128,1,32,2,2,21,23,4649,81,4774
128,1,32,2,2,21,23,4649,77,4770
128,2,16,2,2,21,23,4651,167,4862
128,2,16,2,2,22,26,4652,122,4822
128,2,16,2,2,21,24,4649,157,4851
128,2,16,2,2,29,27,4651,132,4839
128,2,16,2,2,21,22,4648,107,4798
128,2,16,2,2,22,26,4651,125,4824
128,2,16,2,2,22,23,4647,76,4768
128,2,16,2,2,22,23,4646,86,4777
128,2,16,2,2,21,23,4654,129,4827
128,2,16,2,2,39,40,4661,183,4923
128,4,8,2,2,22,23,4646,79,4770
128,4,8,2,2,21,22,4647,133,4823
128,4,8,2,2,21,23,4647,97,4788
128,4,8,2,2,21,22,4646,78,4767
128,4,8,2,2,22,22,4658,236,4938
128,4,8,2,2,21,24,4650,134,4829
128,4,8,2,2,22,24,4647,86,4779
128,4,8,2,2,22,22,4646,75,4765
128,4,8,2,2,21,22,4649,146,4838
128,4,8,2,2,22,22,4646,84,4774
128,8,4,2,2,21,22,4645,78,4766
128,8,4,2,2,23,32,4651,144,4850
128,8,4,2,2,22,23,4648,83,4776
128,8,4,2,2,21,22,4645,74,4762
128,8,4,2,2,21,23,4648,128,4820
128,8,4,2,2,32,27,4656,122,4837
128,8,4,2,2,21,22,4646,103,4792
128,8,4,2,2,21,22,4647,80,4770
128,8,4,2,2,22,22,4647,78,4769
128,8,4,2,2,21,22,4647,75,4765
128,16,2,2,2,22,23,4651,136,4832
128,16,2,2,2,21,24,4647,88,4780
128,16,2,2,2,22,22,4651,120,4815
128,16,2,2,2,26,28,4654,212,4920
128,16,2,2,2,22,23,4646,75,4766
128,16,2,2,2,21,22,4657,166,4866
128,16,2,2,2,27,51,4651,139,4868
128,16,2,2,2,32,23,4647,76,4778
128,16,2,2,2,22,23,4654,157,4856
128,16,2,2,2,21,22,4648,122,4813
128,32,1,2,2,21,22,4646,74,4763
128,32,1,2,2,21,23,4649,123,4816
128,32,1,2,2,21,25,4648,118,4812
128,32,1,2,2,21,22,4646,77,4766
128,32,1,2,2,21,21,4647,232,4921
128,32,1,2,2,21,23,4649,145,4838
128,32,1,2,2,21,23,4647,108,4799
128,32,1,2,2,21,22,4646,77,4766
128,32,1,2,2,21,21,4646,78,4766
128,32,1,2,2,21,23,4649,113,4806
128,1,64,2,1,21,24,4611,81,4737
128,1,64,2,1,21,21,4595,102,4739
128,1,64,2,1,22,30,4609,141,4802
128,1,64,2,1,21,25,4597,90,4733
128,1,64,2,1,22,25,4601,124,4772
128,1,64,2,1,21,22,4596,107,4746
128,1,64,2,1,21,22,4595,73,4711
128,1,64,2,1,21,23,4595,94,4733
128,1,64,2,1,21,40,4611,83,4755
128,1,64,2,1,21,22,4595,78,4716
128,2,32,2,1,21,22,4591,136,4770
128,2,32,2,1,21,23,4594,151,4789
128,2,32,2,1,21,24,4592,86,4723
128,2,32,2,1,22,22,4593,76,4713
128,2,32,2,1,21,22,4590,95,4728
128,2,32,2,1,22,22,4593,135,4772
128,2,32,2,1,21,22,4588,75,4706
128,2,32,2,1,22,22,4593,134,4771
128,2,32,2,1,21,25,4591,100,4737
128,2,32,2,1,21,22,4591,75,4709
128,4,16,2,1,21,22,4589,150,4782
128,4,16,2,1,22,25,4596,143,4786
128,4,16,2,1,22,23,4586,83,4714
128,4,16,2,1,22,22,4593,260,4897
128,4,16,2,1,22,24,4590,127,4763
128,4,16,2,1,22,22,4587,80,4711
128,4,16,2,1,22,24,4593,161,4800
128,4,16,2,1,22,22,4587,86,4717
128,4,16,2,1,44,33,4609,97,4783
128,4,16,2,1,22,24,4591,144,4781
128,8,8,2,1,22,22,4598,99,4741
128,8,8,2,1,40,30,4596,148,4814
128,8,8,2,1,33,28,4594,97,4752
128,8,8,2,1,22,22,4589,138,4771
128,8,8,2,1,22,25,4589,124,4760
128,8,8,2,1,22,22,4587,79,4710
128,8,8,2,1,22,30,4591,130,4773
128,8,8,2,1,33,25,4593,206,4857
128,8,8,2,1,21,23,4587,217,4848
128,8,8,2,1,22,24,4588,94,4728
128,16,4,2,1,22,22,4585,103,4732
128,16,4,2,1,34,24,4585,89,4732
128,16,4,2,1,32,24,4588,196,4840
128,16,4,2,1,22,22,4587,117,4748
128,16,4,2,1,22,24,4587,94,4727
128,16,4,2,1,22,23,4586,78,4709
128,16,4,2,1,22,22,4588,148,4780
128,16,4,2,1,22,24,4587,102,4735
128,16,4,2,1,43,36,4612,123,4814
128,16,4,2,1,25,29,4593,149,4796
128,32,2,2,1,22,25,4590,117,4754
128,32,2,2,1,33,25,4590,107,4755
128,32,2,2,1,32,32,4598,128,4790
128,32,2,2,1,22,23,4586,89,4720
128,32,2,2,1,33,25,4591,97,4746
128,32,2,2,1,22,22,4584,95,4723
128,32,2,2,1,22,23,4588,79,4712
128,32,2,2,1,22,24,4590,233,4869
128,32,2,2,1,22,22,4580,81,4705
128,32,2,2,1,22,23,4586,79,4710
128,64,1,2,1,31,30,4616,137,4814
128,64,1,2,1,21,22,4602,102,4747
128,64,1,2,1,22,25,4606,129,4782
128,64,1,2,1,22,24,4602,84,4732
128,64,1,2,1,22,23,4604,75,4724
128,64,1,2,1,21,22,4609,144,4796
128,64,1,2,1,22,22,4606,94,4744
128,64,1,2,1,29,33,4614,130,4806
128,64,1,2,1,33,24,4610,186,4853
128,64,1,2,1,37,28,4614,149,4828
128,1,128,1,1,22,22,4603,79,4726
128,1,128,1,1,21,22,4605,158,4806
128,1,128,1,1,21,23,4606,138,4788
128,1,128,1,1,21,23,4603,93,4740
128,1,128,1,1,22,22,4602,75,4721
128,1,128,1,1,21,22,4605,172,4820
128,1,128,1,1,21,23,4603,100,4747
128,1,128,1,1,21,23,4603,115,4762
128,1,128,1,1,22,22,4606,170,4820
128,1,128,1,1,21,27,4608,136,4792
128,2,64,1,1,21,23,4603,82,4729
128,2,64,1,1,21,22,4601,75,4719
128,2,64,1,1,22,24,4605,119,4770
128,2,64,1,1,21,22,4600,76,4719
128,2,64,1,1,21,22,4600,76,4719
128,2,64,1,1,22,22,4604,125,4773
128,2,64,1,1,32,26,4603,101,4762
128,2,64,1,1,21,22,4603,77,4723
128,2,64,1,1,22,23,4608,136,4789
128,2,64,1,1,21,26,4607,120,4774
128,4,32,1,1,21,23,4601,86,4731
128,4,32,1,1,22,24,4605,163,4814
128,4,32,1,1,22,23,4607,234,4886
128,4,32,1,1,22,22,4602,79,4725
128,4,32,1,1,21,22,4602,75,4720
128,4,32,1,1,21,22,4607,162,4812
128,4,32,1,1,67,24,4608,125,4824
128,4,32,1,1,21,25,4608,82,4736
128,4,32,1,1,21,22,4601,74,4718
128,4,32,1,1,21,22,4605,149,4797
128,8,16,1,1,22,22,4605,145,4794
128,8,16,1,1,22,23,4605,145,4795
128,8,16,1,1,32,63,4606,90,4791
128,8,16,1,1,22,22,4603,79,4726
128,8,16,1,1,32,27,4608,138,4805
128,8,16,1,1,22,23,4608,174,4827
128,8,16,1,1,22,22,4605,80,4729
128,8,16,1,1,33,36,4605,136,4810
128,8,16,1,1,27,29,4610,130,4796
128,8,16,1,1,22,24,4607,100,4753
128,16,8,1,1,22,22,4602,76,4722
128,16,8,1,1,32,24,4606,137,4799
128,16,8,1,1,22,23,4601,82,4728
128,16,8,1,1,38,28,4609,197,4872
128,16,8,1,1,22,22,4602,87,4733
128,16,8,1,1,22,32,4622,143,4819
128,16,8,1,1,21,22,4602,78,4723
128,16,8,1,1,22,22,4608,197,4849
128,16,8,1,1,33,25,4610,130,4798
128,16,8,1,1,22,23,4606,131,4782
128,32,4,1,1,23,26,4607,200,4856
128,32,4,1,1,21,23,4610,336,4990
128,32,4,1,1,22,23,4602,96,4743
128,32,4,1,1,22,23,4606,132,4783
128,32,4,1,1,31,31,4612,174,4848
128,32,4,1,1,22,22,4602,80,4726
128,32,4,1,1,21,22,4603,89,4735
128,32,4,1,1,21,22,4602,78,4723
128,32,4,1,1,27,22,4604,155,4808
128,32,4,1,1,22,24,4605,135,4786
128,64,2,1,1,22,22,4606,150,4800
128,64,2,1,1,33,26,4605,122,4786
128,64,2,1,1,32,23,4600,74,4729
128,64,2,1,1,22,22,4605,141,4790
128,64,2,1,1,22,24,4604,81,4731
128,64,2,1,1,40,39,4616,141,4836
128,64,2,1,1,31,32,4611,191,4865
128,64,2,1,1,22,38,4609,84,4753
128,64,2,1,1,22,23,4602,76,4723
128,64,2,1,1,21,22,4602,116,4761
128,128,1,1,1,22,22,4613,78,4735
128,128,1,1,1,21,24,4615,83,4743
128,128,1,1,1,40,31,4622,157,4850
128,128,1,1,1,22,23,4615,102,4762
128,128,1,1,1,23,25,4616,195,4859
128,128,1,1,1,21,22,4612,87,4742
128,128,1,1,1,22,24,4616,155,4817
128,128,1,1,1,21,23,4616,136,4796
128,128,1,1,1,33,24,4613,83,4753
128,128,1,1,1,22,23,4616,150,4811
128,1,256,1,1,22,25,4607,180,4834
128,1,256,1,1,22,25,4604,108,4759
128,1,256,1,1,22,22,4602,80,4726
128,1,256,1,1,21,22,4601,88,4732
128,1,256,1,1,24,26,4610,126,4786
128,1,256,1,1,22,23,4601,79,4725
128,1,256,1,1,57,22,4608,209,4896
128,1,256,1,1,22,26,4607,118,4773
128,1,256,1,1,21,22,4602,83,4728
128,1,256,1,1,21,22,4606,170,4819
128,2,128,1,1,32,25,4603,99,4759
128,2,128,1,1,25,22,4602,76,4725
128,2,128,1,1,22,23,4606,135,4786
128,2,128,1,1,22,24,4603,80,4729
128,2,128,1,1,21,21,4623,321,4986
128,2,128,1,1,22,26,4607,113,4768
128,2,128,1,1,22,23,4606,142,4793
128,2,128,1,1,22,23,4609,140,4794
128,2,128,1,1,22,24,4612,90,4748
128,2,128,1,1,22,23,4606,135,4786
128,4,64,1,1,21,23,4603,85,4732
128,4,64,1,1,21,22,4603,73,4719
128,4,64,1,1,21,22,4605,135,4783
128,4,64,1,1,22,25,4604,82,4733
128,4,64,1,1,21,22,4602,76,4721
128,4,64,1,1,21,22,4605,141,4789
128,4,64,1,1,21,25,4606,128,4780
128,4,64,1,1,22,22,4605,137,4786
128,4,64,1,1,22,24,4603,94,4743
128,4,64,1,1,22,22,4601,80,4725
128,8,32,1,1,31,25,4606,128,4790
128,8,32,1,1,21,21,4601,74,4717
128,8,32,1,1,22,23,4603,139,4787
128,8,32,1,1,22,25,4611,127,4785
128,8,32,1,1,22,24,4602,80,4728
128,8,32,1,1,21,21,4606,141,4789
128,8,32,1,1,22,25,4610,151,4808
128,8,32,1,1,22,23,4602,78,4725
128,8,32,1,1,22,23,4608,196,4849
128,8,32,1,1,21,23,4614,121,4779
128,16,16,1,1,22,22,4606,190,4840
128,16,16,1,1,32,25,4604,100,4761
128,16,16,1,1,21,22,4602,75,4720
128,16,16,1,1,22,24,4608,135,4789
128,16,16,1,1,21,24,4603,78,4726
128,16,16,1,1,21,22,4602,88,4733
128,16,16,1,1,21,22,4607,163,4813
128,16,16,1,1,21,23,4602,84,4730
128,16,16,1,1,22,22,4604,79,4727
128,16,16,1,1,35,26,4607,143,4811
128,32,8,1,1,21,23,4603,77,4724
128,32,8,1,1,22,23,4610,173,4828
128,32,8,1,1,22,23,4605,114,4764
128,32,8,1,1,22,23,4603,76,4724
128,32,8,1,1,29,25,4607,146,4807
128,32,8,1,1,21,23,4604,126,4774
128,32,8,1,1,21,22,4603,79,4725
128,32,8,1,1,22,22,4603,85,4732
128,32,8,1,1,27,28,4607,118,4780
128,32,8,1,1,22,23,4605,85,4735
128,64,4,1,1,21,22,4603,78,4724
128,64,4,1,1,79,36,4602,77,4794
128,64,4,1,1,21,23,4627,211,4882
128,64,4,1,1,22,23,4604,91,4740
128,64,4,1,1,40,25,4621,126,4812
128,64,4,1,1,21,22,4604,137,4784
128,64,4,1,1,22,26,4606,102,4756
128,64,4,1,1,21,22,4602,75,4720
128,64,4,1,1,21,22,4605,148,4796
128,64,4,1,1,22,22,4604,86,4734
128,128,2,1,1,21,22,4603,76,4722
128,128,2,1,1,22,23,4610,136,4791
128,128,2,1,1,21,23,4604,125,4773
128,128,2,1,1,21,22,4608,176,4827
128,128,2,1,1,21,23,4607,153,4804
128,128,2,1,1,21,22,4603,76,4722
128,128,2,1,1,21,22,4602,143,4788
128,128,2,1,1,24,30,4607,119,4780
128,128,2,1,1,21,23,4601,76,4721
128,128,2,1,1,21,22,4605,150,4798
128,256,1,1,1,28,27,4618,107,4780
128,256,1,1,1,21,22,4615,74,4732
128,256,1,1,1,22,22,4618,153,4815
128,256,1,1,1,38,28,4620,185,4871
128,256,1,1,1,28,29,4629,152,4838
128,256,1,1,1,22,22,4614,82,4740
128,256,1,1,1,22,22,4612,104,4760
128,256,1,1,1,21,23,4615,99,4758
128,256,1,1,1,21,22,4616,74,4733
128,256,1,1,1,32,24,4616,129,4801
256,1,32,2,4,44,24,9092,84,9244
256,1,32,2,4,44,23,9092,125,9284
256,1,32,2,4,43,24,9099,222,9388
256,1,32,2,4,43,23,9090,92,9248
256,1,32,2,4,43,23,9092,137,9295
256,1,32,2,4,43,23,9093,126,9285
256,1,32,2,4,44,24,9095,125,9288
256,1,32,2,4,43,24,9093,113,9273
256,1,32,2,4,44,26,9098,130,9298
256,1,32,2,4,42,22,9094,144,9302
256,2,16,2,4,43,23,9089,98,9253
256,2,16,2,4,44,29,9095,129,9297
256,2,16,2,4,42,23,9091,178,9334
256,2,16,2,4,49,37,9098,194,9378
256,2,16,2,4,47,24,9091,138,9300
256,2,16,2,4,59,28,9094,172,9353
256,2,16,2,4,59,40,9098,175,9372
256,2,16,2,4,43,23,9087,103,9256
256,2,16,2,4,44,30,9096,121,9291
256,2,16,2,4,65,24,9090,145,9324
256,4,8,2,4,43,23,9109,179,9354
256,4,8,2,4,42,24,9088,123,9277
256,4,8,2,4,53,31,9094,137,9315
256,4,8,2,4,42,22,9094,226,9384
256,4,8,2,4,64,25,9093,98,9280
256,4,8,2,4,42,23,9090,127,9282
256,4,8,2,4,43,23,9089,168,9323
256,4,8,2,4,44,26,9091,117,9278
256,4,8,2,4,42,23,9089,139,9293
256,4,8,2,4,43,24,9087,81,9235
256,8,4,2,4,49,24,9089,126,9288
256,8,4,2,4,42,23,9090,134,9289
256,8,4,2,4,44,23,9087,86,9240
256,8,4,2,4,42,22,9090,129,9283
256,8,4,2,4,42,22,9092,254,9410
256,8,4,2,4,42,25,9088,101,9256
256,8,4,2,4,49,45,9109,197,9400
256,8,4,2,4,43,23,9089,126,9281
256,8,4,2,4,43,23,9089,131,9286
256,8,4,2,4,44,25,9090,122,9281
256,16,2,2,4,43,28,9093,156,9320
256,16,2,2,4,42,22,9090,155,9309
256,16,2,2,4,43,24,9088,84,9239
256,16,2,2,4,51,49,9100,128,9328
256,16,2,2,4,43,23,9090,146,9302
256,16,2,2,4,42,24,9088,80,9234
256,16,2,2,4,44,28,9094,122,9288
256,16,2,2,4,42,23,9089,134,9288
256,16,2,2,4,43,23,9087,83,9236
256,16,2,2,4,75,42,9096,127,9340
256,32,1,2,4,53,52,9088,128,9321
256,32,1,2,4,42,22,9095,217,9376
256,32,1,2,4,44,27,9090,112,9273
256,32,1,2,4,43,23,9090,130,9286
256,32,1,2,4,56,24,9089,133,9302
256,32,1,2,4,64,25,9098,143,9330
256,32,1,2,4,42,23,9090,131,9286
256,32,1,2,4,66,26,9087,84,9263
256,32,1,2,4,120,43,9088,120,9371
256,32,1,2,4,43,23,9089,148,9303
256,1,64,2,2,42,22,9057,79,9200
256,1,64,2,2,43,24,9062,122,9251
256,1,64,2,2,42,23,9059,131,9255
256,1,64,2,2,43,26,9064,134,9267
256,1,64,2,2,44,31,9064,134,9273
256,1,64,2,2,43,23,9058,179,9303
256,1,64,2,2,42,23,9061,79,9205
256,1,64,2,2,42,23,9059,126,9250
256,1,64,2,2,59,30,9067,305,9461
256,1,64,2,2,43,23,9059,117,9242
256,2,32,2,2,57,31,9057,138,9283
256,2,32,2,2,44,26,9055,129,9254
256,2,32,2,2,42,22,9056,279,9399
256,2,32,2,2,43,23,9054,128,9248
256,2,32,2,2,42,22,9052,139,9255
256,2,32,2,2,42,22,9058,163,9285
256,2,32,2,2,42,24,9056,85,9207
256,2,32,2,2,54,24,9064,128,9270
256,2,32,2,2,42,23,9053,164,9282
256,2,32,2,2,43,23,9064,194,9324
256,4,16,2,2,43,23,9055,132,9253
256,4,16,2,2,42,22,9051,131,9246
256,4,16,2,2,43,23,9046,81,9193
256,4,16,2,2,44,23,9053,130,9250
256,4,16,2,2,42,22,9058,158,9280
256,4,16,2,2,42,27,9052,101,9222
256,4,16,2,2,42,22,9054,136,9254
256,4,16,2,2,42,22,9057,214,9335
256,4,16,2,2,43,24,9050,86,9203
256,4,16,2,2,42,22,9052,127,9243
256,8,8,2,2,42,23,9057,250,9372
256,8,8,2,2,59,23,9050,138,9270
256,8,8,2,2,44,23,9054,130,9251
256,8,8,2,2,43,23,9052,194,9312
256,8,8,2,2,44,25,9057,127,9253
256,8,8,2,2,56,23,9056,131,9266
256,8,8,2,2,42,23,9053,327,9445
256,8,8,2,2,44,26,9056,122,9248
256,8,8,2,2,42,22,9048,138,9250
256,8,8,2,2,43,24,9050,79,9196
256,16,4,2,2,45,24,9051,132,9252
256,16,4,2,2,43,23,9052,144,9262
256,16,4,2,2,44,24,9053,80,9201
256,16,4,2,2,42,23,9051,129,9245
256,16,4,2,2,43,23,9054,161,9281
256,16,4,2,2,42,23,9050,81,9196
256,16,4,2,2,42,22,9049,129,9242
256,16,4,2,2,43,25,9054,168,9290
256,16,4,2,2,50,31,9055,135,9271
256,16,4,2,2,42,22,9053,201,9318
256,32,2,2,2,42,22,9051,129,9244
256,32,2,2,2,56,24,9047,91,9218
256,32,2,2,2,42,22,9047,143,9254
256,32,2,2,2,43,23,9047,77,9190
256,32,2,2,2,42,22,9048,126,9238
256,32,2,2,2,43,22,9049,173,9287
256,32,2,2,2,43,24,9048,120,9235
256,32,2,2,2,42,23,9051,165,9281
256,32,2,2,2,42,23,9047,209,9321
256,32,2,2,2,43,24,9048,148,9263
256,64,1,2,2,42,23,9053,125,9243
256,64,1,2,2,43,23,9052,213,9331
256,64,1,2,2,43,24,9053,164,9284
256,64,1,2,2,44,23,9050,83,9200
256,64,1,2,2,43,24,9059,133,9259
256,64,1,2,2,43,23,9050,159,9275
256,64,1,2,2,43,23,9052,80,9198
256,64,1,2,2,43,23,9049,126,9241
256,64,1,2,2,48,23,9053,136,9260
256,64,1,2,2,66,25,9047,92,9230
256,1,128,2,1,43,22,8929,130,9124
256,1,128,2,1,43,24,8928,97,9092
256,1,128,2,1,42,22,8932,145,9141
256,1,128,2,1,43,23,8928,85,9079
256,1,128,2,1,42,23,8930,129,9124
256,1,128,2,1,42,23,8929,125,9119
256,1,128,2,1,87,32,8958,132,9209
256,1,128,2,1,42,23,8932,269,9266
256,1,128,2,1,43,23,8929,122,9117
256,1,128,2,1,42,22,8930,134,9128
256,2,64,2,1,42,22,8923,89,9076
256,2,64,2,1,42,22,8924,125,9113
256,2,64,2,1,42,22,8926,151,9141
256,2,64,2,1,43,23,8924,247,9237
256,2,64,2,1,44,29,8933,132,9138
256,2,64,2,1,43,23,8925,147,9138
256,2,64,2,1,43,24,8922,82,9071
256,2,64,2,1,101,88,8928,119,9236
256,2,64,2,1,43,23,8925,139,9130
256,2,64,2,1,44,25,8924,82,9075
256,4,32,2,1,64,24,8917,126,9131
256,4,32,2,1,43,25,8922,171,9161
256,4,32,2,1,65,25,8923,209,9222
256,4,32,2,1,43,25,8922,129,9119
256,4,32,2,1,43,22,8920,171,9156
256,4,32,2,1,42,24,8916,86,9068
256,4,32,2,1,49,47,8932,155,9183
256,4,32,2,1,43,22,8919,129,9113
256,4,32,2,1,44,28,8921,125,9118
256,4,32,2,1,43,23,8919,145,9130
256,8,16,2,1,43,24,8916,82,9065
256,8,16,2,1,43,23,8919,126,9111
256,8,16,2,1,42,22,8919,174,9157
256,8,16,2,1,44,35,8937,102,9118
256,8,16,2,1,43,22,8919,153,9137
256,8,16,2,1,42,23,8917,154,9136
256,8,16,2,1,64,24,8919,187,9194
256,8,16,2,1,43,24,8921,126,9114
256,8,16,2,1,43,23,8919,143,9128
256,8,16,2,1,42,23,8922,81,9068
256,16,8,2,1,48,22,8915,126,9111
256,16,8,2,1,42,23,8913,141,9119
256,16,8,2,1,63,66,8940,138,9207
256,16,8,2,1,42,23,8917,205,9187
256,16,8,2,1,98,25,8916,101,9140
256,16,8,2,1,44,26,8919,125,9114
256,16,8,2,1,43,23,8917,128,9111
256,16,8,2,1,44,24,8914,83,9065
256,16,8,2,1,42,23,8915,127,9107
256,16,8,2,1,63,24,8914,126,9127
256,32,4,2,1,64,29,8912,125,9130
256,32,4,2,1,43,23,8913,136,9115
256,32,4,2,1,42,23,8908,81,9054
256,32,4,2,1,43,23,8910,125,9101
256,32,4,2,1,43,23,8910,88,9064
256,32,4,2,1,55,25,8912,123,9115
256,32,4,2,1,43,23,8911,143,9120
256,32,4,2,1,44,26,8916,128,9114
256,32,4,2,1,44,25,8913,145,9127
256,32,4,2,1,42,23,8915,203,9183
256,64,2,2,1,44,24,8900,82,9050
256,64,2,2,1,44,23,8903,183,9153
256,64,2,2,1,42,23,8899,85,9049
256,64,2,2,1,42,23,8905,133,9103
256,64,2,2,1,53,34,8914,141,9142
256,64,2,2,1,44,25,8902,125,9096
256,64,2,2,1,44,24,8901,130,9099
256,64,2,2,1,44,25,8903,156,9128
256,64,2,2,1,43,23,8902,158,9126
256,64,2,2,1,43,23,8903,136,9105
256,128,1,2,1,54,30,8928,161,9173
256,128,1,2,1,43,23,8925,146,9137
256,128,1,2,1,44,23,8924,152,9143
256,128,1,2,1,43,24,8925,146,9138
256,128,1,2,1,43,23,8924,200,9190
256,128,1,2,1,44,24,8922,86,9076
256,128,1,2,1,44,31,8925,113,9113
256,128,1,2,1,68,46,8938,126,9178
256,128,1,2,1,43,23,8925,172,9163
256,128,1,2,1,43,25,8920,83,9071
256,1,256,1,1,43,23,9001,121,9188
256,1,256,1,1,42,43,9003,129,9217
256,1,256,1,1,43,25,9002,136,9206
256,1,256,1,1,43,23,9000,146,9212
256,1,256,1,1,44,29,9007,121,9201
256,1,256,1,1,42,22,9000,127,9191
256,1,256,1,1,42,22,9005,194,9263
256,1,256,1,1,43,23,8999,81,9146
256,1,256,1,1,44,25,9002,127,9198
256,1,256,1,1,43,22,9005,184,9254
256,2,128,1,1,43,23,9000,89,9155
256,2,128,1,1,42,21,9002,146,9211
256,2,128,1,1,52,46,9037,226,9361
256,2,128,1,1,43,23,9001,133,9200
256,2,128,1,1,52,28,8999,125,9204
256,2,128,1,1,43,23,9002,158,9226
256,2,128,1,1,43,22,8995,82,9142
256,2,128,1,1,42,22,8999,126,9189
256,2,128,1,1,43,23,9000,140,9206
256,2,128,1,1,58,29,9003,177,9267
256,4,64,1,1,43,23,9005,227,9298
256,4,64,1,1,42,43,9000,130,9215
256,4,64,1,1,42,23,8998,161,9224
256,4,64,1,1,43,23,8998,95,9159
256,4,64,1,1,42,23,9001,128,9194
256,4,64,1,1,43,23,8997,170,9233
256,4,64,1,1,64,25,8999,95,9183
256,4,64,1,1,42,22,8999,125,9188
256,4,64,1,1,43,23,8997,125,9188
256,4,64,1,1,44,39,9006,124,9213
256,8,32,1,1,42,22,9003,131,9198
256,8,32,1,1,42,23,8996,83,9144
256,8,32,1,1,53,26,9004,129,9212
256,8,32,1,1,56,23,9006,245,9330
256,8,32,1,1,42,25,8999,112,9178
256,8,32,1,1,42,22,9000,143,9207
256,8,32,1,1,44,23,9001,128,9196
256,8,32,1,1,43,23,9001,134,9201
256,8,32,1,1,43,24,8997,84,9148
256,8,32,1,1,42,22,8999,124,9187
256,16,16,1,1,42,24,8995,82,9143
256,16,16,1,1,43,25,9000,123,9191
256,16,16,1,1,43,22,9001,132,9198
256,16,16,1,1,44,23,9002,157,9226
256,16,16,1,1,44,24,8998,92,9158
256,16,16,1,1,43,23,8998,134,9198
256,16,16,1,1,42,23,8998,89,9152
256,16,16,1,1,42,23,9000,128,9193
256,16,16,1,1,42,23,8996,80,9141
256,16,16,1,1,44,24,9001,93,9162
256,32,8,1,1,42,23,8999,152,9216
256,32,8,1,1,43,24,8999,126,9192
256,32,8,1,1,42,23,8997,132,9194
256,32,8,1,1,42,23,9008,121,9194
256,32,8,1,1,51,27,9002,128,9208
256,32,8,1,1,42,22,9002,133,9199
256,32,8,1,1,62,25,9001,92,9180
256,32,8,1,1,74,55,9015,183,9327
256,32,8,1,1,45,24,8999,80,9148
256,32,8,1,1,43,23,8999,128,9193
256,64,4,1,1,42,22,8999,151,9214
256,64,4,1,1,44,23,8997,85,9149
256,64,4,1,1,44,23,9000,132,9199
256,64,4,1,1,43,23,9001,154,9221
256,64,4,1,1,42,24,8997,87,9150
256,64,4,1,1,42,23,9001,143,9209
256,64,4,1,1,42,23,8999,171,9235
256,64,4,1,1,44,25,8999,125,9193
256,64,4,1,1,43,22,8999,146,9210
256,64,4,1,1,42,22,8997,117,9178
256,128,2,1,1,42,24,8999,166,9231
256,128,2,1,1,44,25,8996,89,9154
256,128,2,1,1,42,22,8998,132,9194
256,128,2,1,1,42,23,8998,143,9206
256,128,2,1,1,58,27,8997,131,9213
256,128,2,1,1,47,22,8997,144,9210
256,128,2,1,1,43,22,8996,176,9237
256,128,2,1,1,43,22,8994,93,9152
256,128,2,1,1,42,24,9000,124,9190
256,128,2,1,1,42,23,8999,215,9279
256,256,1,1,1,43,24,9014,88,9169
256,256,1,1,1,65,24,9017,91,9197
256,256,1,1,1,42,22,9023,130,9217
256,256,1,1,1,42,24,9016,102,9184
256,256,1,1,1,43,47,9020,124,9234
256,256,1,1,1,42,23,9018,144,9227
256,256,1,1,1,42,25,9016,83,9166
256,256,1,1,1,42,23,9016,124,9205
256,256,1,1,1,42,22,9017,94,9175
256,256,1,1,1,44,27,9022,120,9213
512,1,32,4,4,85,23,17864,127,18099
512,1,32,4,4,88,31,17868,156,18143
512,1,32,4,4,87,25,17865,131,18108
512,1,32,4,4,132,25,17859,127,18143
512,1,32,4,4,87,23,17865,128,18103
512,1,32,4,4,85,23,17862,130,18100
512,1,32,4,4,84,22,17862,136,18104
512,1,32,4,4,85,26,17866,132,18109
512,1,32,4,4,84,23,17860,130,18097
512,1,32,4,4,87,23,17866,136,18112
512,2,16,4,4,87,24,17861,125,18097
512,2,16,4,4,118,24,17877,289,18308
512,2,16,4,4,87,24,17867,151,18129
512,2,16,4,4,87,25,17870,128,18110
512,2,16,4,4,87,24,17863,124,18098
512,2,16,4,4,87,24,17863,128,18102
512,2,16,4,4,84,24,17863,126,18097
512,2,16,4,4,84,24,17863,122,18093
512,2,16,4,4,135,51,17874,163,18223
512,2,16,4,4,127,25,17860,131,18143
512,4,8,4,4,84,24,17859,141,18108
512,4,8,4,4,87,24,17861,131,18103
512,4,8,4,4,112,31,17861,154,18158
512,4,8,4,4,85,25,17861,128,18099
512,4,8,4,4,84,23,17860,131,18098
512,4,8,4,4,84,23,17857,131,18095
512,4,8,4,4,104,23,17859,127,18113
512,4,8,4,4,84,23,17858,130,18095
512,4,8,4,4,127,33,17876,187,18223
512,4,8,4,4,87,25,17861,171,18144
512,8,4,4,4,85,23,17863,136,18107
512,8,4,4,4,87,25,17861,135,18108
512,8,4,4,4,142,36,17866,166,18210
512,8,4,4,4,165,81,17863,129,18238
512,8,4,4,4,85,22,17864,155,18126
512,8,4,4,4,84,24,17861,142,18111
512,8,4,4,4,109,26,17868,137,18140
512,8,4,4,4,85,25,17858,132,18100
512,8,4,4,4,87,22,17861,167,18137
512,8,4,4,4,84,24,17861,126,18095
512,16,2,4,4,86,22,17859,127,18094
512,16,2,4,4,87,25,17863,140,18115
512,16,2,4,4,87,24,17861,139,18111
512,16,2,4,4,87,24,17861,131,18103
512,16,2,4,4,84,23,17863,130,18100
512,16,2,4,4,85,23,17860,128,18096
512,16,2,4,4,84,32,17868,160,18144
512,16,2,4,4,119,28,17863,145,18155
512,16,2,4,4,84,24,17863,127,18098
512,16,2,4,4,85,24,17861,131,18101
512,32,1,4,4,85,22,17864,133,18104
512,32,1,4,4,87,25,17863,134,18109
512,32,1,4,4,84,24,17863,133,18104
512,32,1,4,4,84,23,17863,128,18098
512,32,1,4,4,85,24,17862,131,18102
512,32,1,4,4,87,24,17865,140,18116
512,32,1,4,4,127,25,17865,178,18195
512,32,1,4,4,87,24,17863,128,18102
512,32,1,4,4,85,23,17863,143,18114
512,32,1,4,4,141,25,17861,131,18158
512,1,64,2,4,87,24,17918,136,18165
512,1,64,2,4,85,23,17923,130,18161
512,1,64,2,4,87,29,17923,184,18223
512,1,64,2,4,85,25,17926,129,18165
512,1,64,2,4,84,23,17925,169,18201
512,1,64,2,4,85,23,17907,130,18145
512,1,64,2,4,87,24,17919,129,18159
512,1,64,2,4,153,38,17932,160,18283
512,1,64,2,4,85,24,17913,140,18162
512,1,64,2,4,158,28,17921,145,18252
512,2,32,2,4,87,22,17910,124,18143
512,2,32,2,4,85,23,17911,122,18141
512,2,32,2,4,85,24,17915,176,18200
512,2,32,2,4,85,24,17916,128,18153
512,2,32,2,4,85,23,17913,130,18151
512,2,32,2,4,87,24,17927,143,18181
512,2,32,2,4,149,44,17936,183,18312
512,2,32,2,4,87,25,17920,134,18166
512,2,32,2,4,127,25,17912,134,18198
512,2,32,2,4,87,24,17917,135,18163
512,4,16,2,4,87,24,17914,160,18185
512,4,16,2,4,85,23,17903,126,18137
512,4,16,2,4,85,22,17901,126,18134
512,4,16,2,4,85,23,17903,129,18140
512,4,16,2,4,87,24,17901,138,18150
512,4,16,2,4,85,26,17911,201,18223
512,4,16,2,4,87,25,17912,132,18156
512,4,16,2,4,84,23,17904,137,18148
512,4,16,2,4,84,23,17903,127,18137
512,4,16,2,4,84,24,17915,131,18154
512,8,8,2,4,85,27,17908,192,18212
512,8,8,2,4,88,28,17917,144,18177
512,8,8,2,4,85,25,17911,129,18150
512,8,8,2,4,87,24,17909,130,18150
512,8,8,2,4,84,24,17905,126,18139
512,8,8,2,4,87,25,17903,185,18200
512,8,8,2,4,127,27,17908,144,18206
512,8,8,2,4,85,25,17907,129,18146
512,8,8,2,4,84,24,17902,130,18140
512,8,8,2,4,157,24,17903,125,18209
512,16,4,2,4,84,24,17919,181,18208
512,16,4,2,4,85,26,17918,141,18170
512,16,4,2,4,87,24,17923,125,18159
512,16,4,2,4,87,24,17912,128,18151
512,16,4,2,4,87,24,17914,127,18152
512,16,4,2,4,85,24,17924,137,18170
512,16,4,2,4,85,25,17923,132,18165
512,16,4,2,4,87,24,17915,138,18164
512,16,4,2,4,120,24,17908,130,18182
512,16,4,2,4,87,24,17914,125,18150
512,32,2,2,4,84,23,17899,157,18163
512,32,2,2,4,85,26,17895,129,18135
512,32,2,2,4,84,23,17903,130,18140
512,32,2,2,4,85,25,17895,204,18209
512,32,2,2,4,109,48,17913,162,18232
512,32,2,2,4,127,26,17896,152,18201
512,32,2,2,4,84,22,17892,136,18134
512,32,2,2,4,84,23,17887,128,18122
512,32,2,2,4,84,23,17892,141,18140
512,32,2,2,4,109,27,17891,148,18175
512,64,1,2,4,85,25,17925,130,18165
512,64,1,2,4,87,24,17932,130,18173
512,64,1,2,4,85,22,17936,129,18172
512,64,1,2,4,87,24,17937,131,18179
512,64,1,2,4,87,24,17925,130,18166
512,64,1,2,4,85,25,17944,172,18226
512,64,1,2,4,154,31,17947,133,18265
512,64,1,2,4,129,34,17935,201,18299
512,64,1,2,4,87,24,17932,133,18176
512,64,1,2,4,91,25,17929,131,18176
512,1,128,2,2,85,24,17689,266,18064
512,1,128,2,2,85,25,17678,130,17918
512,1,128,2,2,87,24,17671,148,17930
512,1,128,2,2,87,23,17672,131,17913
512,1,128,2,2,84,22,17676,124,17906
512,1,128,2,2,85,28,17676,180,17969
512,1,128,2,2,85,25,17674,130,17914
512,1,128,2,2,84,23,17670,129,17906
512,1,128,2,2,84,23,17670,125,17902
512,1,128,2,2,85,23,17672,126,17906
512,2,64,2,2,84,23,17666,173,17946
512,2,64,2,2,85,26,17665,127,17903
512,2,64,2,2,87,24,17666,157,17934
512,2,64,2,2,85,23,17664,138,17910
512,2,64,2,2,84,23,17664,168,17939
512,2,64,2,2,84,24,17665,129,17902
512,2,64,2,2,87,24,17667,126,17904
512,2,64,2,2,85,22,17662,135,17904
512,2,64,2,2,87,25,17669,165,17946
512,2,64,2,2,87,24,17670,856,18637
512,4,32,2,2,130,27,17657,129,17943
512,4,32,2,2,126,27,17660,128,17941
512,4,32,2,2,84,24,17662,131,17901
512,4,32,2,2,87,24,17658,129,17898
512,4,32,2,2,367,35,17664,164,18230
512,4,32,2,2,84,25,17661,131,17901
512,4,32,2,2,87,23,17663,202,17975
512,4,32,2,2,84,23,17659,131,17897
512,4,32,2,2,113,24,17663,127,17927
512,4,32,2,2,84,24,17660,129,17897
512,8,16,2,2,84,24,17662,129,17899
512,8,16,2,2,111,31,17665,139,17946
512,8,16,2,2,85,24,17662,139,17910
512,8,16,2,2,85,22,17663,130,17900
512,8,16,2,2,84,24,17660,132,17900
512,8,16,2,2,85,22,17662,131,17900
512,8,16,2,2,103,33,17666,132,17934
512,8,16,2,2,87,24,17683,134,17928
512,8,16,2,2,84,23,17675,291,18073
512,8,16,2,2,110,23,17663,148,17944
512,16,8,2,2,85,24,17658,148,17915
512,16,8,2,2,84,24,17658,145,17911
512,16,8,2,2,125,25,17656,144,17950
512,16,8,2,2,84,22,17658,129,17893
512,16,8,2,2,85,23,17658,132,17898
512,16,8,2,2,87,23,17663,128,17901
512,16,8,2,2,87,26,17663,182,17958
512,16,8,2,2,87,25,17660,170,17942
512,16,8,2,2,87,27,17663,144,17921
512,16,8,2,2,125,27,17660,148,17960
512,32,4,2,2,85,25,17654,133,17897
512,32,4,2,2,87,27,17657,203,17974
512,32,4,2,2,85,23,17653,124,17885
512,32,4,2,2,84,23,17655,136,17898
512,32,4,2,2,85,26,17655,175,17941
512,32,4,2,2,85,25,17655,161,17926
512,32,4,2,2,85,23,17657,152,17917
512,32,4,2,2,84,24,17653,139,17900
512,32,4,2,2,85,24,17655,128,17892
512,32,4,2,2,87,24,17656,252,18019
512,64,2,2,2,87,25,17651,160,17923
512,64,2,2,2,85,27,17650,132,17894
512,64,2,2,2,85,24,17653,125,17887
512,64,2,2,2,84,22,17646,127,17879
512,64,2,2,2,85,25,17648,131,17889
512,64,2,2,2,85,27,17654,141,17907
512,64,2,2,2,87,24,17647,119,17877
512,64,2,2,2,132,22,17649,131,17934
512,64,2,2,2,85,25,17648,146,17904
512,64,2,2,2,125,24,17647,139,17935
512,128,1,2,2,84,23,17644,127,17878
512,128,1,2,2,84,23,17645,122,17874
512,128,1,2,2,84,24,17642,133,17883
512,128,1,2,2,85,23,17663,158,17929
512,128,1,2,2,121,30,17649,131,17931
512,128,1,2,2,87,24,17645,131,17887
512,128,1,2,2,87,25,17647,132,17891
512,128,1,2,2,84,24,17646,125,17879
512,128,1,2,2,84,23,17649,129,17885
512,128,1,2,2,85,23,17671,143,17922
512,1,256,2,1,87,24,17684,128,17923
512,1,256,2,1,85,25,17690,168,17968
512,1,256,2,1,85,25,17686,129,17925
512,1,256,2,1,84,23,17687,133,17927
512,1,256,2,1,85,24,17683,138,17930
512,1,256,2,1,84,24,17680,123,17911
512,1,256,2,1,87,24,17682,125,17918
512,1,256,2,1,85,23,17683,129,17920
512,1,256,2,1,85,23,17682,130,17920
512,1,256,2,1,84,23,17683,153,17943
512,2,128,2,1,85,24,17673,128,17910
512,2,128,2,1,85,25,17677,129,17916
512,2,128,2,1,84,23,17677,130,17914
512,2,128,2,1,85,24,17670,127,17906
512,2,128,2,1,131,24,17671,152,17978
512,2,128,2,1,85,25,17674,206,17990
512,2,128,2,1,87,24,17671,153,17935
512,2,128,2,1,84,23,17675,218,18000
512,2,128,2,1,151,24,17673,127,17975
512,2,128,2,1,84,23,17674,129,17910
512,4,64,2,1,85,24,17669,181,17959
512,4,64,2,1,85,23,17673,226,18007
512,4,64,2,1,84,24,17668,145,17921
512,4,64,2,1,85,24,17669,126,17904
512,4,64,2,1,85,25,17673,135,17918
512,4,64,2,1,85,24,17663,134,17906
512,4,64,2,1,85,25,17667,130,17907
512,4,64,2,1,126,25,17668,143,17962
512,4,64,2,1,127,25,17668,136,17956
512,4,64,2,1,84,23,17665,131,17903
512,8,32,2,1,110,29,17669,133,17941
512,8,32,2,1,85,25,17666,167,17943
512,8,32,2,1,87,25,17665,150,17927
512,8,32,2,1,87,25,17667,129,17908
512,8,32,2,1,121,30,17669,131,17951
512,8,32,2,1,87,24,17665,130,17906
512,8,32,2,1,84,24,17665,126,17899
512,8,32,2,1,84,23,17662,124,17893
512,8,32,2,1,122,24,17666,130,17942
512,8,32,2,1,85,24,17663,126,17898
512,16,16,2,1,85,25,17675,361,18146
512,16,16,2,1,126,25,17674,220,18045
512,16,16,2,1,87,25,17658,131,17901
512,16,16,2,1,84,23,17658,126,17891
512,16,16,2,1,87,24,17659,126,17896
512,16,16,2,1,87,24,17660,132,17903
512,16,16,2,1,84,23,17660,126,17893
512,16,16,2,1,84,24,17664,134,17906
512,16,16,2,1,84,24,17665,129,17902
512,16,16,2,1,87,24,17664,125,17900
512,32,8,2,1,84,23,17652,128,17887
512,32,8,2,1,129,25,17655,172,17981
512,32,8,2,1,85,27,17692,149,17953
512,32,8,2,1,85,24,17649,126,17884
512,32,8,2,1,84,24,17651,137,17896
512,32,8,2,1,84,24,17649,129,17886
512,32,8,2,1,84,24,17648,127,17883
512,32,8,2,1,85,23,17649,132,17889
512,32,8,2,1,84,24,17651,136,17895
512,32,8,2,1,111,25,17654,152,17942
512,64,4,2,1,92,24,17637,134,17887
512,64,4,2,1,85,23,17635,129,17872
512,64,4,2,1,84,23,17636,134,17877
512,64,4,2,1,86,24,17637,140,17887
512,64,4,2,1,87,26,17644,259,18016
512,64,4,2,1,85,24,17639,185,17933
512,64,4,2,1,85,25,17642,153,17905
512,64,4,2,1,84,23,17638,143,17888
512,64,4,2,1,84,24,17640,135,17883
512,64,4,2,1,87,24,17639,132,17882
512,128,2,2,1,127,24,17640,160,17951
512,128,2,2,1,127,25,17634,126,17912
512,128,2,2,1,85,24,17636,124,17869
512,128,2,2,1,84,24,17637,128,17873
512,128,2,2,1,86,26,17641,180,17933
512,128,2,2,1,127,26,17642,139,17934
512,128,2,2,1,84,24,17641,222,17971
512,128,2,2,1,85,25,17638,149,17897
512,128,2,2,1,87,25,17639,142,17893
512,128,2,2,1,85,23,17635,129,17872
512,256,1,2,1,101,46,17693,174,18014
512,256,1,2,1,87,25,17681,167,17960
512,256,1,2,1,121,25,17682,133,17961
512,256,1,2,1,87,24,17677,142,17930
512,256,1,2,1,87,25,17687,186,17985
512,256,1,2,1,107,44,17684,131,17966
512,256,1,2,1,109,41,17689,135,17974
512,256,1,2,1,91,24,17680,149,17944
512,256,1,2,1,138,27,17680,154,17999
512,256,1,2,1,131,27,17675,147,17980
1024,1,32,4,8,260,28,35624,157,36069
1024,1,32,4,8,169,25,35620,153,35967
1024,1,32,4,8,173,28,35624,131,35956
1024,1,32,4,8,173,26,35623,137,35959
1024,1,32,4,8,169,28,35623,129,35949
1024,1,32,4,8,169,29,35617,151,35966
1024,1,32,4,8,169,26,35353,125,35673
1024,1,32,4,8,173,26,33393,134,33726
1024,1,32,4,8,173,26,33383,131,33713
1024,1,32,4,8,169,26,33381,131,33707
1024,2,16,4,8,293,36,36951,225,37505
1024,2,16,4,8,172,26,33384,133,33715
1024,2,16,4,8,173,26,33374,127,33700
1024,2,16,4,8,170,29,33372,142,33713
1024,2,16,4,8,173,30,33358,165,33726
1024,2,16,4,8,169,27,30923,142,31261
1024,2,16,4,8,169,27,30922,186,31304
1024,2,16,4,8,248,28,30931,136,31343
1024,2,16,4,8,169,28,30925,193,31315
1024,2,16,4,8,225,52,30937,182,31396
1024,4,8,4,8,169,26,30911,146,31252
1024,4,8,4,8,169,27,30916,148,31260
1024,4,8,4,8,174,28,30914,148,31264
1024,4,8,4,8,256,29,30915,146,31346
1024,4,8,4,8,169,26,30915,152,31262
1024,4,8,4,8,185,28,30915,191,31319
1024,4,8,4,8,173,26,30912,140,31251
1024,4,8,4,8,174,28,30921,151,31274
1024,4,8,4,8,169,26,30909,190,31294
1024,4,8,4,8,169,26,30918,212,31325
1024,8,4,4,8,209,28,30913,149,31299
1024,8,4,4,8,173,27,30917,171,31288
1024,8,4,4,8,188,30,30913,149,31280
1024,8,4,4,8,254,28,30914,182,31378
1024,8,4,4,8,169,27,30915,199,31310
1024,8,4,4,8,182,35,30919,194,31330
1024,8,4,4,8,169,26,30911,152,31258
1024,8,4,4,8,174,28,30918,174,31294
1024,8,4,4,8,247,28,30919,150,31344
1024,8,4,4,8,169,26,30908,176,31279
1024,16,2,4,8,203,27,30913,168,31311
1024,16,2,4,8,169,27,30911,141,31248
1024,16,2,4,8,253,29,30920,302,31504
1024,16,2,4,8,177,29,30915,214,31335
1024,16,2,4,8,180,60,30906,158,31304
1024,16,2,4,8,250,30,30915,176,31371
1024,16,2,4,8,378,33,30914,216,31541
1024,16,2,4,8,250,28,30912,212,31402
1024,16,2,4,8,169,28,30916,142,31255
1024,16,2,4,8,169,26,30915,142,31252
1024,32,1,4,8,170,29,30928,241,31368
1024,32,1,4,8,169,29,30940,291,31429
1024,32,1,4,8,269,29,30932,183,31413
1024,32,1,4,8,170,31,30932,245,31378
1024,32,1,4,8,197,29,30929,145,31300
1024,32,1,4,8,173,27,30925,144,31269
1024,32,1,4,8,174,29,30936,158,31297
1024,32,1,4,8,173,26,30933,140,31272
1024,32,1,4,8,169,26,30933,134,31262
1024,32,1,4,8,169,25,30933,133,31260
1024,1,64,4,4,169,26,30929,133,31257
1024,1,64,4,4,306,27,30936,139,31408
1024,1,64,4,4,193,28,30944,140,31305
1024,1,64,4,4,199,27,30938,135,31299
1024,1,64,4,4,169,25,30932,129,31255
1024,1,64,4,4,169,25,30938,132,31264
1024,1,64,4,4,173,26,30927,129,31255
1024,1,64,4,4,169,26,30941,131,31267
1024,1,64,4,4,169,26,30931,133,31259
1024,1,64,4,4,169,26,30937,157,31289
1024,2,32,4,4,169,25,30908,131,31233
1024,2,32,4,4,173,27,30909,178,31287
1024,2,32,4,4,169,25,30910,147,31251
1024,2,32,4,4,169,27,30907,144,31247
1024,2,32,4,4,169,26,30906,144,31245
1024,2,32,4,4,169,27,30911,216,31323
1024,2,32,4,4,178,27,30914,182,31301
1024,2,32,4,4,169,28,30909,173,31279
1024,2,32,4,4,255,28,30919,186,31388
1024,2,32,4,4,174,26,30912,141,31253
1024,4,16,4,4,169,26,30910,162,31267
1024,4,16,4,4,169,28,30908,166,31271
1024,4,16,4,4,169,26,30918,155,31268
1024,4,16,4,4,169,26,30909,313,31417
1024,4,16,4,4,169,28,30907,145,31249
1024,4,16,4,4,200,26,30904,139,31269
1024,4,16,4,4,173,26,30905,146,31250
1024,4,16,4,4,169,27,30908,175,31279
1024,4,16,4,4,260,28,30906,159,31353
1024,4,16,4,4,193,28,30901,158,31280
1024,8,8,4,4,173,25,30908,135,31241
1024,8,8,4,4,169,26,30903,167,31265
1024,8,8,4,4,169,28,30904,158,31259
1024,8,8,4,4,173,29,30906,161,31269
1024,8,8,4,4,260,28,30902,154,31344
1024,8,8,4,4,278,33,30905,133,31349
1024,8,8,4,4,257,26,30910,151,31344
1024,8,8,4,4,173,26,30895,153,31247
1024,8,8,4,4,169,25,30903,140,31237
1024,8,8,4,4,175,26,30909,138,31248
1024,16,4,4,4,170,27,30899,157,31253
1024,16,4,4,4,169,26,30902,220,31317
1024,16,4,4,4,169,28,30910,189,31296
1024,16,4,4,4,240,27,30904,149,31320
1024,16,4,4,4,178,32,30908,136,31254
1024,16,4,4,4,169,26,30899,152,31246
1024,16,4,4,4,173,25,30896,135,31229
1024,16,4,4,4,174,27,30902,151,31254
1024,16,4,4,4,206,27,30911,161,31305
1024,16,4,4,4,173,26,30909,145,31253
1024,32,2,4,4,173,27,30921,177,31298
1024,32,2,4,4,253,27,30910,138,31328
1024,32,2,4,4,170,28,30912,176,31286
1024,32,2,4,4,169,27,30921,220,31337
1024,32,2,4,4,169,28,30909,157,31263
1024,32,2,4,4,169,27,30908,147,31251
1024,32,2,4,4,169,26,30916,143,31254
1024,32,2,4,4,216,36,30920,238,31410
1024,32,2,4,4,174,28,30909,168,31279
1024,32,2,4,4,248,28,30915,242,31433
1024,64,1,4,4,169,28,30907,145,31249
1024,64,1,4,4,169,29,30904,160,31262
1024,64,1,4,4,169,27,30904,155,31255
1024,64,1,4,4,169,27,30899,133,31228
1024,64,1,4,4,208,41,30904,248,31401
1024,64,1,4,4,170,29,30897,150,31246
1024,64,1,4,4,169,26,30900,163,31258
1024,64,1,4,4,249,34,30899,220,31402
1024,64,1,4,4,169,25,30891,135,31220
1024,64,1,4,4,173,26,30893,139,31231
1024,1,128,2,4,169,25,30734,155,31083
1024,1,128,2,4,169,26,30727,131,31053
1024,1,128,2,4,174,28,30733,222,31157
1024,1,128,2,4,169,29,30739,228,31165
1024,1,128,2,4,170,29,30730,132,31061
1024,1,128,2,4,169,26,30728,185,31108
1024,1,128,2,4,213,26,30736,141,31116
1024,1,128,2,4,169,25,30732,153,31079
1024,1,128,2,4,169,25,30731,156,31081
1024,1,128,2,4,173,28,30731,174,31106
1024,2,64,2,4,169,29,30728,139,31065
1024,2,64,2,4,205,32,30728,131,31096
1024,2,64,2,4,169,26,30721,136,31052
1024,2,64,2,4,169,25,30724,131,31049
1024,2,64,2,4,169,26,30720,134,31049
1024,2,64,2,4,169,25,30730,137,31061
1024,2,64,2,4,173,26,30724,135,31058
1024,2,64,2,4,169,26,30720,132,31047
1024,2,64,2,4,169,26,30724,137,31056
1024,2,64,2,4,173,26,30729,134,31062
1024,4,32,2,4,173,26,30712,168,31079
1024,4,32,2,4,169,26,30712,136,31043
1024,4,32,2,4,170,28,30719,207,31124
1024,4,32,2,4,169,31,30720,129,31049
1024,4,32,2,4,227,26,30713,131,31097
1024,4,32,2,4,169,26,30708,134,31037
1024,4,32,2,4,169,25,30713,133,31040
1024,4,32,2,4,173,26,30713,166,31078
1024,4,32,2,4,169,26,30712,153,31060
1024,4,32,2,4,169,27,30720,188,31104
1024,8,16,2,4,174,32,30720,181,31107
1024,8,16,2,4,201,62,30729,132,31124
1024,8,16,2,4,169,25,30712,176,31082
1024,8,16,2,4,169,25,30718,135,31047
1024,8,16,2,4,169,25,30713,137,31044
1024,8,16,2,4,169,25,30715,136,31045
1024,8,16,2,4,227,26,30713,169,31135
1024,8,16,2,4,174,26,30710,134,31044
1024,8,16,2,4,169,25,30717,137,31048
1024,8,16,2,4,179,27,30710,151,31067
1024,16,8,2,4,169,27,30717,191,31104
1024,16,8,2,4,169,26,30716,135,31046
1024,16,8,2,4,180,37,30717,131,31065
1024,16,8,2,4,173,28,30710,153,31064
1024,16,8,2,4,170,27,30712,139,31048
1024,16,8,2,4,169,27,30714,154,31064
1024,16,8,2,4,169,27,30713,169,31078
1024,16,8,2,4,169,28,30713,190,31100
1024,16,8,2,4,224,28,30705,130,31087
1024,16,8,2,4,192,68,30727,136,31123
1024,32,4,2,4,169,25,30714,131,31039
1024,32,4,2,4,169,25,30715,134,31043
1024,32,4,2,4,169,25,30709,135,31038
1024,32,4,2,4,169,25,30712,131,31037
1024,32,4,2,4,173,27,30714,148,31062
1024,32,4,2,4,179,27,30711,165,31082
1024,32,4,2,4,169,46,30718,150,31083
1024,32,4,2,4,173,29,30715,176,31093
1024,32,4,2,4,201,41,30709,126,31077
1024,32,4,2,4,169,25,30714,135,31043
1024,64,2,2,4,169,25,30710,132,31036
1024,64,2,2,4,170,27,30714,143,31054
1024,64,2,2,4,169,25,30707,130,31031
1024,64,2,2,4,169,26,30718,131,31044
1024,64,2,2,4,203,37,30714,164,31118
1024,64,2,2,4,169,26,30702,127,31024
1024,64,2,2,4,173,26,30711,131,31041
1024,64,2,2,4,254,28,30712,217,31211
1024,64,2,2,4,193,61,30711,128,31093
1024,64,2,2,4,169,26,30712,133,31040
1024,128,1,2,4,169,26,30699,132,31026
1024,128,1,2,4,169,26,30711,162,31068
1024,128,1,2,4,190,29,30708,144,31071
1024,128,1,2,4,173,26,30707,139,31045
1024,128,1,2,4,198,36,30718,194,31146
1024,128,1,2,4,173,26,30707,136,31042
1024,128,1,2,4,173,26,30712,135,31046
1024,128,1,2,4,208,35,30701,157,31101
1024,128,1,2,4,175,38,30716,139,31068
1024,128,1,2,4,183,28,30706,138,31055
1024,1,256,2,2,173,26,30700,138,31037
1024,1,256,2,2,174,26,30702,175,31077
1024,1,256,2,2,173,26,30699,133,31031
1024,1,256,2,2,176,26,30701,158,31061
1024,1,256,2,2,169,26,30704,132,31031
1024,1,256,2,2,170,26,30701,181,31078
1024,1,256,2,2,173,26,30701,141,31041
1024,1,256,2,2,169,26,30701,144,31040
1024,1,256,2,2,169,26,30703,141,31039
1024,1,256,2,2,169,26,30705,218,31118
1024,2,128,2,2,170,28,30693,149,31040
1024,2,128,2,2,169,28,30692,182,31071
1024,2,128,2,2,169,27,30692,168,31056
1024,2,128,2,2,169,29,30697,142,31037
1024,2,128,2,2,253,29,30697,185,31164
1024,2,128,2,2,169,27,30696,219,31111
1024,2,128,2,2,169,28,30694,162,31053
1024,2,128,2,2,191,26,30704,228,31149
1024,2,128,2,2,173,30,30700,204,31107
1024,2,128,2,2,170,27,30696,168,31061
1024,4,64,2,2,174,28,30688,164,31054
1024,4,64,2,2,169,29,30685,175,31058
1024,4,64,2,2,177,34,30693,233,31137
1024,4,64,2,2,238,41,30690,140,31109
1024,4,64,2,2,173,26,30685,132,31016
1024,4,64,2,2,169,25,30684,133,31011
1024,4,64,2,2,169,28,30685,132,31014
1024,4,64,2,2,190,25,30687,138,31040
1024,4,64,2,2,169,25,30684,134,31012
1024,4,64,2,2,169,25,30684,132,31010
1024,8,32,2,2,219,26,30684,132,31061
1024,8,32,2,2,169,34,30704,130,31037
1024,8,32,2,2,169,25,30680,139,31013
1024,8,32,2,2,169,25,30683,157,31034
1024,8,32,2,2,173,25,30684,197,31079
1024,8,32,2,2,188,28,30688,163,31067
1024,8,32,2,2,224,29,30686,209,31148
1024,8,32,2,2,173,26,30682,137,31018
1024,8,32,2,2,183,27,30684,136,31030
1024,8,32,2,2,174,26,30686,166,31052
1024,16,16,2,2,170,27,30680,139,31016
1024,16,16,2,2,169,25,30686,135,31015
1024,16,16,2,2,173,27,30681,133,31014
1024,16,16,2,2,169,25,30676,129,30999
1024,16,16,2,2,173,26,30676,130,31005
1024,16,16,2,2,216,26,30683,134,31059
1024,16,16,2,2,173,26,30678,139,31016
1024,16,16,2,2,224,31,30681,134,31070
1024,16,16,2,2,214,38,30685,155,31092
1024,16,16,2,2,169,26,30682,161,31038
1024,32,8,2,2,287,46,30682,201,31216
1024,32,8,2,2,169,25,30677,170,31041
1024,32,8,2,2,169,27,30674,210,31080
1024,32,8,2,2,169,25,30676,130,31000
1024,32,8,2,2,204,37,30676,129,31046
1024,32,8,2,2,212,25,30676,132,31045
1024,32,8,2,2,173,26,30673,138,31010
1024,32,8,2,2,169,26,30672,175,31042
1024,32,8,2,2,169,30,30675,152,31026
1024,32,8,2,2,173,26,30676,154,31029
1024,64,4,2,2,169,27,30664,176,31036
1024,64,4,2,2,169,26,30666,161,31022
1024,64,4,2,2,169,33,30668,150,31020
1024,64,4,2,2,200,39,30674,195,31108
1024,64,4,2,2,169,26,30660,143,30998
1024,64,4,2,2,169,27,30664,167,31027
1024,64,4,2,2,169,28,30665,172,31034
1024,64,4,2,2,173,26,30667,177,31043
1024,64,4,2,2,169,26,30665,149,31009
1024,64,4,2,2,169,25,30660,147,31001
1024,128,2,2,2,169,26,30661,142,30998
1024,128,2,2,2,210,29,30666,140,31045
1024,128,2,2,2,230,31,30662,141,31064
1024,128,2,2,2,220,36,30675,142,31073
1024,128,2,2,2,253,38,30674,156,31121
1024,128,2,2,2,254,28,30670,174,31126
1024,128,2,2,2,170,29,30669,174,31042
1024,128,2,2,2,174,29,30666,260,31129
1024,128,2,2,2,169,26,30666,134,30995
1024,128,2,2,2,174,27,30664,210,31075
1024,256,1,2,2,169,26,30664,162,31021
1024,256,1,2,2,215,27,30665,194,31101
1024,256,1,2,2,323,67,30665,140,31195
1024,256,1,2,2,253,28,30666,230,31177
1024,256,1,2,2,169,26,30663,151,31009
1024,256,1,2,2,169,26,30666,168,31029
1024,256,1,2,2,169,27,30667,238,31101
1024,256,1,2,2,252,28,30666,190,31136
1024,256,1,2,2,170,27,30667,140,31004
1024,256,1,2,2,226,30,30664,132,31052
2048,1,32,8,8,337,29,62057,149,62572
2048,1,32,8,8,346,30,62048,142,62566
2048,1,32,8,8,346,30,59124,251,59751
2048,1,32,8,8,338,30,56455,142,56965
2048,1,32,8,8,382,31,54274,191,54878
2048,1,32,8,8,346,29,54266,139,54780
2048,1,32,8,8,337,29,54260,199,54825
2048,1,32,8,8,338,29,54261,143,54771
2048,1,32,8,8,337,28,54246,134,54745
2048,1,32,8,8,425,49,54251,144,54869
2048,2,16,8,8,364,30,54227,182,54803
2048,2,16,8,8,338,28,54230,295,54891
2048,2,16,8,8,338,29,54236,138,54741
2048,2,16,8,8,338,29,54247,439,55053
2048,2,16,8,8,628,50,54238,139,55055
2048,2,16,8,8,347,29,54229,143,54748
2048,2,16,8,8,338,29,54231,144,54742
2048,2,16,8,8,492,37,54229,135,54893
2048,2,16,8,8,337,29,54218,136,54720
2048,2,16,8,8,346,29,54220,169,54764
2048,4,8,8,8,338,31,54235,138,54742
2048,4,8,8,8,346,29,54224,139,54738
2048,4,8,8,8,339,30,54227,153,54749
2048,4,8,8,8,392,32,54236,137,54797
2048,4,8,8,8,338,29,54227,154,54748
2048,4,8,8,8,494,39,54248,139,54920
2048,4,8,8,8,337,29,54231,134,54731
2048,4,8,8,8,338,28,54234,179,54779
2048,4,8,8,8,338,31,54226,137,54732
2048,4,8,8,8,346,29,54232,191,54798
2048,8,4,8,8,433,45,54238,140,54856
2048,8,4,8,8,337,29,54220,142,54728
2048,8,4,8,8,365,30,54229,149,54773
2048,8,4,8,8,456,34,54230,138,54858
2048,8,4,8,8,346,30,54228,136,54740
2048,8,4,8,8,389,30,54221,250,54890
2048,8,4,8,8,337,28,54754,133,55252
2048,8,4,8,8,338,29,54755,202,55324
2048,8,4,8,8,422,31,54757,133,55343
2048,8,4,8,8,346,29,54753,135,55263
2048,16,2,8,8,347,39,54761,166,55313
2048,16,2,8,8,338,31,54757,179,55305
2048,16,2,8,8,427,29,54750,131,55337
2048,16,2,8,8,442,50,54759,144,55395
2048,16,2,8,8,430,31,54752,133,55346
2048,16,2,8,8,346,28,54761,194,55329
2048,16,2,8,8,505,33,54752,137,55427
2048,16,2,8,8,337,29,54759,135,55260
2048,16,2,8,8,469,32,54752,137,55390
2048,16,2,8,8,367,29,54754,264,55414
2048,32,1,8,8,462,50,54767,147,55426
2048,32,1,8,8,346,29,54763,171,55309
2048,32,1,8,8,338,30,54755,140,55263
2048,32,1,8,8,338,29,54796,263,55426
2048,32,1,8,8,338,30,54764,138,55270
2048,32,1,8,8,346,29,54766,165,55306
2048,32,1,8,8,338,31,54765,134,55268
2048,32,1,8,8,337,28,54773,368,55506
2048,32,1,8,8,338,30,54758,134,55260
2048,32,1,8,8,346,29,54756,142,55273
2048,1,64,4,8,347,33,54818,139,55337
2048,1,64,4,8,337,29,54821,136,55323
2048,1,64,4,8,337,29,54825,166,55357
2048,1,64,4,8,338,30,54823,138,55329
2048,1,64,4,8,338,29,54820,146,55333
2048,1,64,4,8,487,34,54830,140,55491
2048,1,64,4,8,338,29,54830,168,55365
2048,1,64,4,8,358,33,54828,141,55360
2048,1,64,4,8,375,32,54835,215,55457
2048,1,64,4,8,347,31,54821,136,55335
2048,2,32,4,8,337,28,54798,130,55293
2048,2,32,4,8,348,29,54798,152,55327
2048,2,32,4,8,338,28,54796,185,55347
2048,2,32,4,8,435,54,54813,158,55460
2048,2,32,4,8,337,29,54797,142,55305
2048,2,32,4,8,338,28,54796,142,55304
2048,2,32,4,8,340,37,54808,155,55340
2048,2,32,4,8,337,29,54800,134,55300
2048,2,32,4,8,338,29,54793,138,55298
2048,2,32,4,8,337,39,54803,148,55327
2048,4,16,4,8,339,36,54797,152,55324
2048,4,16,4,8,340,28,54792,136,55296
2048,4,16,4,8,379,29,54796,143,55347
2048,4,16,4,8,375,32,54796,135,55338
2048,4,16,4,8,338,29,54784,173,55324
2048,4,16,4,8,395,36,54801,164,55396
2048,4,16,4,8,337,29,54790,138,55294
2048,4,16,4,8,337,28,54795,197,55357
2048,4,16,4,8,532,35,54795,141,55503
2048,4,16,4,8,349,31,54797,137,55314
2048,8,8,4,8,347,29,54798,240,55414
2048,8,8,4,8,360,42,54799,148,55349
2048,8,8,4,8,344,29,54790,137,55300
2048,8,8,4,8,384,29,54787,153,55353
2048,8,8,4,8,409,31,54795,134,55369
2048,8,8,4,8,338,29,54794,136,55297
2048,8,8,4,8,338,29,54794,167,55328
2048,8,8,4,8,389,31,54788,136,55344
2048,8,8,4,8,338,28,54791,138,55295
2048,8,8,4,8,338,31,54791,157,55317
2048,16,4,4,8,338,30,54794,134,55296
2048,16,4,4,8,338,29,54790,168,55325
2048,16,4,4,8,436,29,54784,166,55415
2048,16,4,4,8,450,36,54792,164,55442
2048,16,4,4,8,338,29,54792,135,55294
2048,16,4,4,8,338,28,54793,192,55351
2048,16,4,4,8,338,31,54787,138,55294
2048,16,4,4,8,338,32,54786,133,55289
2048,16,4,4,8,346,30,54791,141,55308
2048,16,4,4,8,433,29,54792,136,55390
2048,32,2,4,8,347,32,54801,137,55317
2048,32,2,4,8,338,29,54787,136,55290
2048,32,2,4,8,346,29,54797,195,55367
2048,32,2,4,8,346,29,54797,157,55329
2048,32,2,4,8,507,32,54794,134,55467
2048,32,2,4,8,338,28,54802,183,55351
2048,32,2,4,8,338,30,54795,134,55297
2048,32,2,4,8,347,29,54800,135,55311
2048,32,2,4,8,350,32,54799,171,55352
2048,32,2,4,8,338,28,54798,243,55407
2048,64,1,4,8,350,32,54794,146,55322
2048,64,1,4,8,338,28,54790,136,55292
2048,64,1,4,8,338,29,54796,174,55337
2048,64,1,4,8,346,29,54795,135,55305
2048,64,1,4,8,368,51,54804,156,55379
2048,64,1,4,8,338,30,54799,134,55301
2048,64,1,4,8,337,29,54799,144,55309
2048,64,1,4,8,366,53,54801,135,55355
2048,64,1,4,8,338,29,54797,147,55311
2048,64,1,4,8,337,29,54800,175,55341
2048,1,128,4,4,454,34,54874,135,55497
2048,1,128,4,4,338,28,54871,134,55371
2048,1,128,4,4,348,33,54873,158,55412
2048,1,128,4,4,338,29,54866,139,55372
2048,1,128,4,4,346,30,54873,200,55449
2048,1,128,4,4,359,48,54869,138,55414
2048,1,128,4,4,338,28,54861,184,55411
2048,1,128,4,4,338,29,54864,137,55368
2048,1,128,4,4,565,76,54878,157,55676
2048,1,128,4,4,362,30,54871,145,55408
2048,2,64,4,4,338,29,54851,232,55450
2048,2,64,4,4,815,30,54844,138,55827
2048,2,64,4,4,338,29,54839,242,55448
2048,2,64,4,4,340,32,54843,145,55360
2048,2,64,4,4,347,31,54851,162,55391
2048,2,64,4,4,386,33,54843,148,55410
2048,2,64,4,4,337,28,54844,134,55343
2048,2,64,4,4,348,29,54843,176,55396
2048,2,64,4,4,338,30,54845,134,55347
2048,2,64,4,4,338,29,54845,347,55559
2048,4,32,4,4,338,30,54827,141,55336
2048,4,32,4,4,346,29,54822,139,55336
2048,4,32,4,4,338,29,54834,150,55351
2048,4,32,4,4,347,30,54830,139,55346
2048,4,32,4,4,509,30,54835,280,55654
2048,4,32,4,4,339,34,54836,168,55377
2048,4,32,4,4,337,29,54830,137,55333
2048,4,32,4,4,525,31,54834,159,55549
2048,4,32,4,4,464,41,54841,148,55494
2048,4,32,4,4,346,29,54827,163,55365
2048,8,16,4,4,506,38,54832,162,55538
2048,8,16,4,4,369,45,54823,142,55379
2048,8,16,4,4,358,30,54834,186,55408
2048,8,16,4,4,417,33,54825,135,55410
2048,8,16,4,4,348,29,54831,199,55407
2048,8,16,4,4,544,35,54825,149,55553
2048,8,16,4,4,337,28,54823,131,55319
2048,8,16,4,4,379,32,54834,158,55403
2048,8,16,4,4,338,30,54828,136,55332
2048,8,16,4,4,337,29,54834,335,55535
2048,16,8,4,4,338,31,54823,279,55471
2048,16,8,4,4,385,43,54827,173,55428
2048,16,8,4,4,507,30,54825,144,55506
2048,16,8,4,4,338,30,54843,297,55508
2048,16,8,4,4,338,29,54820,136,55323
2048,16,8,4,4,337,29,54819,139,55324
2048,16,8,4,4,338,28,54828,243,55437
2048,16,8,4,4,500,33,54824,148,55505
2048,16,8,4,4,346,30,54826,150,55352
2048,16,8,4,4,347,44,54822,182,55395
2048,32,4,4,4,338,28,54830,135,55331
2048,32,4,4,4,379,39,54830,134,55382
2048,32,4,4,4,346,29,54820,139,55334
2048,32,4,4,4,347,30,54822,138,55337
2048,32,4,4,4,346,29,54821,136,55332
2048,32,4,4,4,338,29,54826,141,55334
2048,32,4,4,4,347,31,54830,134,55342
2048,32,4,4,4,346,29,54822,131,55328
2048,32,4,4,4,359,31,54828,157,55375
2048,32,4,4,4,338,31,54824,138,55331
2048,64,2,4,4,338,28,54825,159,55350
2048,64,2,4,4,339,57,54827,137,55360
2048,64,2,4,4,338,28,54827,138,55331
2048,64,2,4,4,346,29,54824,166,55365
2048,64,2,4,4,338,30,54831,135,55334
2048,64,2,4,4,337,28,54823,136,55324
2048,64,2,4,4,337,29,54827,143,55336
2048,64,2,4,4,338,29,54823,133,55323
2048,64,2,4,4,458,42,54833,136,55469
2048,64,2,4,4,337,28,54826,135,55326
2048,128,1,4,4,337,28,54824,195,55384
2048,128,1,4,4,338,32,54829,134,55333
2048,128,1,4,4,338,29,54826,237,55430
2048,128,1,4,4,476,33,54826,137,55472
2048,128,1,4,4,337,29,54827,134,55327
2048,128,1,4,4,364,43,54833,135,55375
2048,128,1,4,4,338,60,54831,133,55362
2048,128,1,4,4,338,29,54828,184,55379
2048,128,1,4,4,337,29,54829,135,55330
2048,128,1,4,4,338,29,54826,176,55369
2048,1,256,2,4,344,31,54986,141,55502
2048,1,256,2,4,345,31,55007,135,55518
2048,1,256,2,4,337,29,54992,199,55557
2048,1,256,2,4,424,43,54991,136,55594
2048,1,256,2,4,370,29,54989,142,55530
2048,1,256,2,4,346,29,54978,145,55498
2048,1,256,2,4,338,30,55002,275,55645
2048,1,256,2,4,337,29,54995,136,55497
2048,1,256,2,4,508,57,55004,145,55714
2048,1,256,2,4,338,29,55014,139,55520
2048,2,128,2,4,421,46,54978,137,55582
2048,2,128,2,4,338,30,54967,135,55470
2048,2,128,2,4,337,29,54972,196,55534
2048,2,128,2,4,475,82,55003,136,55696
2048,2,128,2,4,338,28,54968,138,55472
2048,2,128,2,4,352,30,54986,160,55528
2048,2,128,2,4,346,30,54973,134,55483
2048,2,128,2,4,1095,31,54967,221,56314
2048,2,128,2,4,555,50,54988,138,55731
2048,2,128,2,4,435,30,54987,157,55609
2048,4,64,2,4,508,30,54977,139,55654
2048,4,64,2,4,338,40,54964,160,55502
2048,4,64,2,4,338,30,54955,148,55471
2048,4,64,2,4,337,28,54945,138,55448
2048,4,64,2,4,338,28,54953,207,55526
2048,4,64,2,4,338,30,54953,138,55459
2048,4,64,2,4,338,30,54952,152,55472
2048,4,64,2,4,346,29,54966,150,55491
2048,4,64,2,4,376,52,54967,138,55533
2048,4,64,2,4,367,30,54955,242,55594
2048,8,32,2,4,410,30,54975,141,55556
2048,8,32,2,4,346,29,54953,173,55501
2048,8,32,2,4,338,30,54945,137,55450
2048,8,32,2,4,346,29,54955,199,55529
2048,8,32,2,4,339,36,54969,139,55483
2048,8,32,2,4,534,31,54951,135,55651
2048,8,32,2,4,340,35,54957,160,55492
2048,8,32,2,4,338,31,54949,142,55460
2048,8,32,2,4,338,28,54955,172,55493
2048,8,32,2,4,390,32,54963,136,55521
2048,16,16,2,4,409,30,54947,151,55537
2048,16,16,2,4,367,33,54947,134,55481
2048,16,16,2,4,337,29,54939,183,55488
2048,16,16,2,4,381,29,54950,180,55540
2048,16,16,2,4,387,31,54951,135,55504
2048,16,16,2,4,346,29,54977,133,55485
2048,16,16,2,4,346,28,54951,179,55504
2048,16,16,2,4,347,30,54950,138,55465
2048,16,16,2,4,338,29,54941,137,55445
2048,16,16,2,4,415,39,54948,167,55569
2048,32,8,2,4,348,29,54935,139,55451
2048,32,8,2,4,338,28,54960,220,55546
2048,32,8,2,4,424,32,54929,140,55525
2048,32,8,2,4,388,29,54944,138,55499
2048,32,8,2,4,582,37,54962,207,55788
2048,32,8,2,4,346,29,54950,142,55467
2048,32,8,2,4,346,29,54948,249,55572
2048,32,8,2,4,346,30,54941,140,55457
2048,32,8,2,4,337,29,54943,222,55531
2048,32,8,2,4,387,36,54941,133,55497
2048,64,4,2,4,337,28,54946,139,55450
2048,64,4,2,4,337,28,54976,166,55507
2048,64,4,2,4,337,30,54942,139,55448
2048,64,4,2,4,339,29,54938,217,55523
2048,64,4,2,4,426,50,54946,135,55557
2048,64,4,2,4,337,29,54949,138,55453
2048,64,4,2,4,347,30,54957,157,55491
2048,64,4,2,4,347,30,54940,142,55459
2048,64,4,2,4,346,29,54945,197,55517
2048,64,4,2,4,341,36,54944,146,55467
2048,128,2,2,4,337,28,54948,137,55450
2048,128,2,2,4,338,29,54942,153,55462
2048,128,2,2,4,375,31,54936,161,55503
2048,128,2,2,4,353,39,54975,153,55520
2048,128,2,2,4,431,37,54944,160,55572
2048,128,2,2,4,508,30,54945,141,55624
2048,128,2,2,4,338,28,54947,182,55495
2048,128,2,2,4,364,30,54965,139,55498
2048,128,2,2,4,362,29,54936,179,55506
2048,128,2,2,4,338,29,54949,136,55452
2048,256,1,2,4,338,29,54961,196,55524
2048,256,1,2,4,347,32,54940,136,55455
2048,256,1,2,4,341,29,54949,137,55456
2048,256,1,2,4,353,49,54954,139,55495
2048,256,1,2,4,353,30,54951,140,55474
2048,256,1,2,4,338,28,54934,145,55445
2048,256,1,2,4,337,30,54943,131,55441
2048,256,1,2,4,338,28,54937,157,55460
2048,256,1,2,4,338,29,54952,135,55454
2048,256,1,2,4,337,28,54937,135,55437
4096,1,32,8,16,747,55,113741,168,114711
4096,1,32,8,16,817,38,113730,176,114761
4096,1,32,8,16,1020,40,113965,181,115206
4096,1,32,8,16,675,37,114564,183,115459
4096,1,32,8,16,675,38,114584,171,115468
4096,1,32,8,16,675,39,114580,156,115450
4096,1,32,8,16,675,39,114555,156,115425
4096,1,32,8,16,675,37,114581,174,115467
4096,1,32,8,16,1043,39,114563,254,115899
4096,1,32,8,16,675,37,114568,167,115447
4096,2,16,8,16,675,37,114459,151,115322
4096,2,16,8,16,692,37,114445,151,115325
4096,2,16,8,16,720,37,114444,157,115358
4096,2,16,8,16,675,37,114463,165,115340
4096,2,16,8,16,802,42,114449,289,115582
4096,2,16,8,16,953,49,114457,184,115643
4096,2,16,8,16,693,40,114465,159,115357
4096,2,16,8,16,907,72,114465,215,115659
4096,2,16,8,16,756,48,114453,159,115416
4096,2,16,8,16,750,59,114461,161,115431
4096,4,8,8,16,694,40,114362,171,115267
4096,4,8,8,16,693,40,114359,168,115260
4096,4,8,8,16,675,38,114363,188,115264
4096,4,8,8,16,675,36,114372,171,115254
4096,4,8,8,16,675,37,114367,159,115238
4096,4,8,8,16,730,38,114368,171,115307
4096,4,8,8,16,1020,53,114373,159,115605
4096,4,8,8,16,703,90,114390,151,115334
4096,4,8,8,16,775,65,114377,153,115370
4096,4,8,8,16,763,49,114392,192,115396
4096,8,4,8,16,692,38,114345,159,115234
4096,8,4,8,16,675,39,114375,160,115249
4096,8,4,8,16,734,38,114365,165,115302
4096,8,4,8,16,675,37,114362,207,115281
4096,8,4,8,16,723,37,114367,174,115301
4096,8,4,8,16,683,37,114372,168,115260
4096,8,4,8,16,731,39,114359,158,115287
4096,8,4,8,16,692,37,114357,176,115262
4096,8,4,8,16,675,37,114368,157,115237
4096,8,4,8,16,675,37,114346,151,115209
4096,16,2,8,16,878,36,114347,150,115411
4096,16,2,8,16,675,36,114342,149,115202
4096,16,2,8,16,866,36,114367,151,115420
4096,16,2,8,16,675,37,114372,148,115232
4096,16,2,8,16,998,38,114351,150,115537
4096,16,2,8,16,728,38,114367,170,115303
4096,16,2,8,16,724,37,114379,173,115313
4096,16,2,8,16,719,37,114359,173,115288
4096,16,2,8,16,736,37,114361,170,115304
4096,16,2,8,16,693,39,114357,150,115239
4096,32,1,8,16,693,37,114353,160,115243
4096,32,1,8,16,675,37,114346,168,115226
4096,32,1,8,16,1165,63,114374,152,115754
4096,32,1,8,16,777,41,114346,149,115313
4096,32,1,8,16,698,40,114340,149,115227
4096,32,1,8,16,1011,38,114353,150,115552
4096,32,1,8,16,675,37,114352,148,115212
4096,32,1,8,16,675,37,114350,172,115234
4096,32,1,8,16,675,36,114346,152,115209
4096,32,1,8,16,675,37,114324,149,115185
4096,1,64,8,8,675,36,113647,154,114512
4096,1,64,8,8,675,37,113660,155,114527
4096,1,64,8,8,675,37,113651,202,114565
4096,1,64,8,8,676,37,113668,152,114533
4096,1,64,8,8,675,36,113642,156,114509
4096,1,64,8,8,729,37,113666,174,114606
4096,1,64,8,8,683,38,113666,171,114558
4096,1,64,8,8,998,38,113645,161,114842
4096,1,64,8,8,675,36,113678,159,114548
4096,1,64,8,8,676,38,113653,166,114533
4096,2,32,8,8,675,37,113555,205,114472
4096,2,32,8,8,675,37,113526,203,114441
4096,2,32,8,8,727,43,113540,367,114677
4096,2,32,8,8,754,45,113523,303,114625
4096,2,32,8,8,738,41,113538,183,114500
4096,2,32,8,8,676,44,113546,151,114417
4096,2,32,8,8,1011,62,113513,167,114753
4096,2,32,8,8,694,40,113537,310,114581
4096,2,32,8,8,1037,50,113541,281,114909
4096,2,32,8,8,819,45,113556,189,114609
4096,4,16,8,8,750,49,113456,146,114401
4096,4,16,8,8,675,37,113457,149,114318
4096,4,16,8,8,675,37,113450,151,114313
4096,4,16,8,8,759,37,113450,149,114395
4096,4,16,8,8,687,55,113463,162,114367
4096,4,16,8,8,732,47,113446,215,114440
4096,4,16,8,8,688,41,113451,162,114342
4096,4,16,8,8,886,97,113450,153,114586
4096,4,16,8,8,675,37,113444,150,114306
4096,4,16,8,8,722,37,113432,180,114371
4096,8,8,8,8,675,37,113439,191,114342
4096,8,8,8,8,723,40,113466,216,114445
4096,8,8,8,8,685,38,113472,150,114345
4096,8,8,8,8,675,37,113458,160,114330
4096,8,8,8,8,675,36,113462,172,114345
4096,8,8,8,8,688,37,113439,157,114321
4096,8,8,8,8,676,40,113439,169,114324
4096,8,8,8,8,692,39,113464,161,114356
4096,8,8,8,8,829,42,113462,322,114655
4096,8,8,8,8,892,48,113430,216,114586
4096,16,4,8,8,844,56,113459,194,114553
4096,16,4,8,8,756,43,113486,177,114462
4096,16,4,8,8,813,44,113445,155,114457
4096,16,4,8,8,675,36,113435,161,114307
4096,16,4,8,8,745,37,113448,198,114428
4096,16,4,8,8,702,37,113467,154,114360
4096,16,4,8,8,675,36,113433,198,114342
4096,16,4,8,8,755,42,113421,313,114531
4096,16,4,8,8,738,41,113443,212,114434
4096,16,4,8,8,725,47,113455,194,114421
4096,32,2,8,8,1040,44,113445,226,114755
4096,32,2,8,8,773,45,113419,152,114389
4096,32,2,8,8,816,48,113457,157,114478
4096,32,2,8,8,721,39,113437,149,114346
4096,32,2,8,8,780,43,113466,159,114448
4096,32,2,8,8,776,39,113461,145,114421
4096,32,2,8,8,744,42,113448,153,114387
4096,32,2,8,8,693,36,113432,164,114325
4096,32,2,8,8,676,40,113471,151,114338
4096,32,2,8,8,723,40,113446,151,114360
4096,64,1,8,8,676,38,113478,196,114388
4096,64,1,8,8,676,39,113432,298,114445
4096,64,1,8,8,694,40,113449,250,114433
4096,64,1,8,8,679,43,113443,149,114314
4096,64,1,8,8,687,43,113468,155,114353
4096,64,1,8,8,930,45,113417,185,114577
4096,64,1,8,8,833,46,113454,165,114498
4096,64,1,8,8,681,44,113468,160,114353
4096,64,1,8,8,694,43,113443,154,114334
4096,64,1,8,8,709,40,113415,151,114315
4096,1,128,4,8,833,45,113141,151,114170
4096,1,128,4,8,788,45,113180,206,114219
4096,1,128,4,8,741,42,113107,149,114039
4096,1,128,4,8,677,39,113149,152,114017
4096,1,128,4,8,713,39,113146,150,114048
4096,1,128,4,8,675,36,113189,165,114065
4096,1,128,4,8,675,37,113152,148,114012
4096,1,128,4,8,675,37,113149,171,114032
4096,1,128,4,8,693,39,113154,159,114045
4096,1,128,4,8,699,38,113169,165,114071
4096,2,64,4,8,675,39,113069,211,113994
4096,2,64,4,8,675,41,113034,253,114003
4096,2,64,4,8,715,37,113067,152,113971
4096,2,64,4,8,692,37,113061,155,113945
4096,2,64,4,8,675,43,113022,148,113888
4096,2,64,4,8,828,49,113031,150,114058
4096,2,64,4,8,780,68,113012,151,114011
4096,2,64,4,8,954,91,113092,154,114291
4096,2,64,4,8,695,39,113094,155,113983
4096,2,64,4,8,675,37,113079,150,113941
4096,4,32,4,8,675,37,113043,151,113906
4096,4,32,4,8,675,36,113043,147,113901
4096,4,32,4,8,675,37,113033,189,113934
4096,4,32,4,8,719,37,113039,165,113960
4096,4,32,4,8,1016,39,113040,187,114282
4096,4,32,4,8,724,43,112967,241,113975
4096,4,32,4,8,1014,41,113035,210,114300
4096,4,32,4,8,695,44,113033,192,113964
4096,4,32,4,8,676,39,113050,209,113974
4096,4,32,4,8,675,39,112997,170,113881
4096,8,16,4,8,676,38,113059,244,114017
4096,8,16,4,8,870,43,112988,349,114250
4096,8,16,4,8,738,40,113030,359,114167
4096,8,16,4,8,850,47,113044,159,114100
4096,8,16,4,8,975,59,113032,196,114262
4096,8,16,4,8,716,99,113074,148,114037
4096,8,16,4,8,675,37,113033,154,113899
4096,8,16,4,8,815,70,113049,159,114093
4096,8,16,4,8,676,73,113054,311,114114
4096,8,16,4,8,703,42,113038,298,114081
4096,16,8,4,8,861,48,113030,383,114322
4096,16,8,4,8,720,41,112985,185,113931
4096,16,8,4,8,676,40,113045,224,113985
4096,16,8,4,8,675,39,112996,196,113906
4096,16,8,4,8,677,42,112993,215,113927
4096,16,8,4,8,1184,45,113048,154,114431
4096,16,8,4,8,692,37,113059,171,113959
4096,16,8,4,8,675,37,113030,210,113952
4096,16,8,4,8,675,37,113024,158,113894
4096,16,8,4,8,675,36,113037,162,113910
4096,32,4,4,8,748,42,113050,186,114026
4096,32,4,4,8,755,42,113018,195,114010
4096,32,4,4,8,675,38,113023,165,113901
4096,32,4,4,8,1035,41,113028,162,114266
4096,32,4,4,8,676,39,112974,231,113920
4096,32,4,4,8,745,46,113043,164,113998
4096,32,4,4,8,777,47,113018,175,114017
4096,32,4,4,8,701,43,113034,170,113948
4096,32,4,4,8,961,63,113010,191,114225
4096,32,4,4,8,738,46,112982,165,113931
4096,64,2,4,8,725,71,113018,151,113965
4096,64,2,4,8,675,37,113011,150,113873
4096,64,2,4,8,711,36,112989,146,113882
4096,64,2,4,8,677,41,113011,169,113898
4096,64,2,4,8,675,38,113019,283,114015
4096,64,2,4,8,676,39,112674,170,113559
4096,64,2,4,8,808,52,112669,205,113734
4096,64,2,4,8,1015,38,112660,187,113900
4096,64,2,4,8,677,39,112644,149,113509
4096,64,2,4,8,675,37,112606,200,113518
4096,128,1,4,8,714,45,112655,153,113567
4096,128,1,4,8,675,36,112644,155,113510
4096,128,1,4,8,722,37,112661,163,113583
4096,128,1,4,8,692,37,112636,188,113553
4096,128,1,4,8,675,37,112628,163,113503
4096,128,1,4,8,693,38,112626,158,113515
4096,128,1,4,8,692,37,112644,150,113523
4096,128,1,4,8,678,39,112618,155,113490
4096,128,1,4,8,675,37,112606,151,113469
4096,128,1,4,8,678,44,112637,154,113513
4096,1,256,4,4,746,44,114671,153,115614
4096,1,256,4,4,675,37,114689,153,115554
4096,1,256,4,4,700,64,114686,154,115604
4096,1,256,4,4,753,59,114699,151,115662
4096,1,256,4,4,693,37,114685,153,115568
4096,1,256,4,4,675,36,114671,150,115532
4096,1,256,4,4,728,38,114703,153,115622
4096,1,256,4,4,724,36,114679,152,115591
4096,1,256,4,4,675,37,114665,152,115529
4096,1,256,4,4,675,37,114698,173,115583
4096,2,128,4,4,693,37,114516,151,115397
4096,2,128,4,4,675,36,114518,152,115381
4096,2,128,4,4,675,37,114558,161,115431
4096,2,128,4,4,675,37,114550,227,115489
4096,2,128,4,4,675,37,114548,168,115428
4096,2,128,4,4,675,37,114550,154,115416
4096,2,128,4,4,675,37,114491,151,115354
4096,2,128,4,4,675,37,114556,156,115424
4096,2,128,4,4,725,37,114545,171,115478
4096,2,128,4,4,721,37,114497,179,115434
4096,4,64,4,4,692,37,114407,152,115288
4096,4,64,4,4,675,36,114351,161,115223
4096,4,64,4,4,675,76,114351,188,115290
4096,4,64,4,4,721,39,114383,160,115303
4096,4,64,4,4,675,38,114388,199,115300
4096,4,64,4,4,678,40,114400,155,115273
4096,4,64,4,4,679,40,114392,217,115328
4096,4,64,4,4,676,40,114395,190,115301
4096,4,64,4,4,677,41,114386,278,115382
4096,4,64,4,4,676,42,114374,203,115295
4096,8,32,4,4,692,37,114386,188,115303
4096,8,32,4,4,809,58,114407,150,115424
4096,8,32,4,4,675,37,114340,223,115275
4096,8,32,4,4,675,37,114315,162,115189
4096,8,32,4,4,675,36,114377,170,115258
4096,8,32,4,4,675,36,114315,155,115181
4096,8,32,4,4,675,37,114361,193,115266
4096,8,32,4,4,792,41,114356,181,115370
4096,8,32,4,4,1026,39,114355,170,115590
4096,8,32,4,4,723,37,114389,195,115344
4096,16,16,4,4,707,41,114303,176,115227
4096,16,16,4,4,675,37,114326,148,115186
4096,16,16,4,4,675,37,114349,150,115211
4096,16,16,4,4,1023,38,114319,155,115535
4096,16,16,4,4,675,36,114337,149,115197
4096,16,16,4,4,675,36,114368,199,115278
4096,16,16,4,4,692,37,114339,156,115224
4096,16,16,4,4,730,48,114303,157,115238
4096,16,16,4,4,692,37,114346,159,115234
4096,16,16,4,4,675,37,114342,214,115268
4096,32,8,4,4,675,37,114283,150,115145
4096,32,8,4,4,675,36,114322,150,115183
4096,32,8,4,4,675,37,114313,158,115183
4096,32,8,4,4,675,36,114336,147,115194
4096,32,8,4,4,675,37,114299,149,115160
4096,32,8,4,4,692,37,114326,161,115216
4096,32,8,4,4,675,37,114332,151,115195
4096,32,8,4,4,692,37,114306,150,115185
4096,32,8,4,4,675,37,114328,148,115188
4096,32,8,4,4,678,37,114339,150,115204
4096,64,4,4,4,675,37,114295,149,115156
4096,64,4,4,4,675,37,114331,155,115198
4096,64,4,4,4,928,43,114305,165,115441
4096,64,4,4,4,692,42,114330,163,115227
4096,64,4,4,4,675,40,114299,192,115206
4096,64,4,4,4,719,39,114352,157,115267
4096,64,4,4,4,752,37,114355,190,115334
4096,64,4,4,4,992,37,114330,183,115542
4096,64,4,4,4,1011,38,114334,206,115589
4096,64,4,4,4,721,38,114343,162,115264
4096,128,2,4,4,675,37,114313,201,115226
4096,128,2,4,4,675,38,114289,175,115177
4096,128,2,4,4,675,36,114335,149,115195
4096,128,2,4,4,725,38,114308,150,115221
4096,128,2,4,4,675,37,114326,173,115211
4096,128,2,4,4,675,37,114291,174,115177
4096,128,2,4,4,1001,38,114339,182,115560
4096,128,2,4,4,675,37,114339,181,115232
4096,128,2,4,4,675,37,114338,197,115247
4096,128,2,4,4,725,38,114317,185,115265
4096,256,1,4,4,770,43,114327,156,115296
4096,256,1,4,4,806,65,114308,148,115327
4096,256,1,4,4,715,50,114332,150,115247
4096,256,1,4,4,693,39,114338,148,115218
4096,256,1,4,4,678,40,114308,153,115179
4096,256,1,4,4,905,131,114309,151,115496
4096,256,1,4,4,677,45,114282,227,115231
4096,256,1,4,4,1017,47,114332,216,115612
4096,256,1,4,4,727,40,114309,197,115273
4096,256,1,4,4,675,41,114290,212,115218
8192,1,32,16,16,1357,49,458743,232,460381
8192,1,32,16,16,1500,51,458915,373,460839
8192,1,32,16,16,1461,56,458766,250,460533
8192,1,32,16,16,1397,52,458830,261,460540
8192,1,32,16,16,1739,136,458920,178,460973
8192,1,32,16,16,1400,47,458735,220,460402
8192,1,32,16,16,1398,49,458799,184,460430
8192,1,32,16,16,1529,70,460493,210,462302
8192,1,32,16,16,1547,53,463523,185,465308
8192,1,32,16,16,1535,131,461194,175,463035
8192,2,16,16,16,1391,70,461601,179,463241
8192,2,16,16,16,1385,51,462428,259,464123
8192,2,16,16,16,1422,51,463061,221,464755
8192,2,16,16,16,1350,48,462674,178,464250
8192,2,16,16,16,1349,48,461926,177,463500
8192,2,16,16,16,2074,107,463244,180,465605
8192,2,16,16,16,1398,80,463263,174,464915
8192,2,16,16,16,1816,106,463180,205,465307
8192,2,16,16,16,1991,142,462398,234,464765
8192,2,16,16,16,1395,50,463066,187,464698
8192,4,8,16,16,1361,50,462823,200,464434
8192,4,8,16,16,1350,49,462861,192,464452
8192,4,8,16,16,1983,74,462839,232,465128
8192,4,8,16,16,1418,68,461843,174,463503
8192,4,8,16,16,1646,99,462853,171,464769
8192,4,8,16,16,1470,211,462333,174,464188
8192,4,8,16,16,1471,56,462238,255,464020
8192,4,8,16,16,1408,66,461506,193,463173
8192,4,8,16,16,1456,107,462812,176,464551
8192,4,8,16,16,1349,47,462864,170,464430
8192,8,4,16,16,1385,49,461634,199,463267
8192,8,4,16,16,1350,48,461878,234,463510
8192,8,4,16,16,1385,57,462997,254,464693
8192,8,4,16,16,1890,68,462820,206,464984
8192,8,4,16,16,1669,86,461911,178,463844
8192,8,4,16,16,1563,138,462495,176,464372
8192,8,4,16,16,1534,158,462805,173,464670
8192,8,4,16,16,1407,159,462804,180,464550
8192,8,4,16,16,1411,95,462997,182,464685
8192,8,4,16,16,1366,75,462120,195,463756
8192,16,2,16,16,1411,94,462828,190,464523
8192,16,2,16,16,1516,62,462990,179,464747
8192,16,2,16,16,1360,92,459316,180,460948
8192,16,2,16,16,1401,50,460485,237,462173
8192,16,2,16,16,1410,48,462785,175,464418
8192,16,2,16,16,1891,121,462900,184,465096
8192,16,2,16,16,1456,50,459944,195,461645
8192,16,2,16,16,1350,48,461079,232,462709
8192,16,2,16,16,1395,67,462930,181,464573
8192,16,2,16,16,1496,70,462961,246,464773
8192,32,1,16,16,1391,48,458836,217,460492
8192,32,1,16,16,1394,48,460527,391,462360
8192,32,1,16,16,1398,67,462953,182,464600
8192,32,1,16,16,1384,49,462748,224,464405
8192,32,1,16,16,1397,55,461625,176,463253
8192,32,1,16,16,1423,49,462593,180,464245
8192,32,1,16,16,1366,48,462917,176,464507
8192,32,1,16,16,1403,47,462864,176,464490
8192,32,1,16,16,1476,89,461888,174,463627
8192,32,1,16,16,1350,47,461668,198,463263
8192,1,64,8,16,1384,48,305016,342,306790
8192,1,64,8,16,1796,67,306127,211,308201
8192,1,64,8,16,1403,85,305613,176,307277
8192,1,64,8,16,1349,47,305333,236,306965
8192,1,64,8,16,2192,61,306154,195,308602
8192,1,64,8,16,1429,79,305884,254,307646
8192,1,64,8,16,1466,65,304382,226,306139
8192,1,64,8,16,1484,117,305860,194,307655
8192,1,64,8,16,1387,50,305839,195,307471
8192,1,64,8,16,1398,50,306253,179,307880
8192,2,32,8,16,1350,51,305677,191,307269
8192,2,32,8,16,1401,49,305605,204,307259
8192,2,32,8,16,1384,48,306069,189,307690
8192,2,32,8,16,1393,51,305648,174,307266
8192,2,32,8,16,1463,97,306442,175,308177
8192,2,32,8,16,1350,47,306137,178,307712
8192,2,32,8,16,1384,49,305686,222,307341
8192,2,32,8,16,1394,51,304252,246,305943
8192,2,32,8,16,1385,50,305754,187,307376
8192,2,32,8,16,1995,80,305519,179,307773
8192,4,16,8,16,1414,48,305877,343,307682
8192,4,16,8,16,1350,49,305417,173,306989
8192,4,16,8,16,1399,77,305818,214,307508
8192,4,16,8,16,1385,48,305738,176,307347
8192,4,16,8,16,1403,49,305448,174,307074
8192,4,16,8,16,1385,48,305980,275,307688
8192,4,16,8,16,1503,58,305694,251,307506
8192,4,16,8,16,1399,49,305508,167,307123
8192,4,16,8,16,1356,60,305961,173,307550
8192,4,16,8,16,1398,52,305489,219,307158
8192,8,8,8,16,1389,60,305431,166,307046
8192,8,8,8,16,1650,74,305891,182,307797
8192,8,8,8,16,1349,48,305483,195,307075
8192,8,8,8,16,1350,48,305299,180,306877
8192,8,8,8,16,1449,69,305809,173,307500
8192,8,8,8,16,2222,91,305546,179,308038
8192,8,8,8,16,1691,73,305305,171,307240
8192,8,8,8,16,1349,48,305701,192,307290
8192,8,8,8,16,1350,48,305449,201,307048
8192,8,8,8,16,1500,51,305629,226,307406
8192,16,4,8,16,1349,48,305573,357,307327
8192,16,4,8,16,1546,60,305137,212,306955
8192,16,4,8,16,1418,96,305929,174,307617
8192,16,4,8,16,1427,50,305600,689,307766
8192,16,4,8,16,1350,47,305422,288,307107
8192,16,4,8,16,1396,50,305853,174,307473
8192,16,4,8,16,1585,70,305313,170,307138
8192,16,4,8,16,1385,49,304136,207,305777
8192,16,4,8,16,1349,48,305814,186,307397
8192,16,4,8,16,1349,48,305783,171,307351
8192,32,2,8,16,1350,48,305828,185,307411
8192,32,2,8,16,1422,88,306412,1071,308993
8192,32,2,8,16,1385,48,306435,175,308043
8192,32,2,8,16,1542,66,306633,174,308415
8192,32,2,8,16,1605,98,305905,175,307783
8192,32,2,8,16,1385,51,306559,188,308183
8192,32,2,8,16,1353,49,305786,170,307358
8192,32,2,8,16,2080,69,306917,184,309250
8192,32,2,8,16,1404,50,306639,208,308301
8192,32,2,8,16,1349,48,305530,200,307127
8192,64,1,8,16,1370,50,305810,167,307397
8192,64,1,8,16,1469,123,306704,184,308480
8192,64,1,8,16,1642,56,304134,179,306011
8192,64,1,8,16,1416,107,305969,177,307669
8192,64,1,8,16,1396,49,306064,183,307692
8192,64,1,8,16,1350,47,305532,556,307485
8192,64,1,8,16,1401,91,305918,215,307625
8192,64,1,8,16,1830,60,305919,237,308046
8192,64,1,8,16,1422,48,305382,1100,307952
8192,64,1,8,16,1450,91,305478,195,307214
8192,1,128,8,8,1680,61,305410,907,308058
8192,1,128,8,8,1385,48,306730,179,308342
8192,1,128,8,8,1672,75,307974,187,309908
8192,1,128,8,8,1423,59,307672,180,309334
8192,1,128,8,8,1349,48,306144,192,307733
8192,1,128,8,8,1418,49,305475,228,307170
8192,1,128,8,8,1423,52,306226,248,307949
8192,1,128,8,8,1349,48,305548,173,307118
8192,1,128,8,8,1393,49,305402,177,307021
8192,1,128,8,8,1941,66,305979,188,308174
8192,2,64,8,8,1385,63,305192,174,306814
8192,2,64,8,8,1600,53,305150,192,306995
8192,2,64,8,8,1409,50,305251,169,306879
8192,2,64,8,8,1536,126,305072,174,306908
8192,2,64,8,8,1350,47,304982,194,306573
8192,2,64,8,8,1392,50,305263,168,306873
8192,2,64,8,8,1352,53,306910,196,308511
8192,2,64,8,8,1349,48,306290,245,307932
8192,2,64,8,8,1394,50,305023,167,306634
8192,2,64,8,8,1445,90,306637,174,308346
8192,4,32,8,8,1584,162,306354,179,308279
8192,4,32,8,8,1359,49,306195,251,307854
8192,4,32,8,8,1396,48,306308,216,307968
8192,4,32,8,8,1385,49,306351,215,308000
8192,4,32,8,8,1429,52,306114,182,307777
8192,4,32,8,8,1433,50,306953,458,308894
8192,4,32,8,8,1350,48,306342,174,307914
8192,4,32,8,8,1356,72,306167,176,307771
8192,4,32,8,8,1411,86,306379,176,308052
8192,4,32,8,8,1417,106,306154,178,307855
8192,8,16,8,8,2016,83,306148,169,308416
8192,8,16,8,8,1736,127,306251,173,308287
8192,8,16,8,8,1349,48,306524,5417,313338
8192,8,16,8,8,1409,49,307032,207,308697
8192,8,16,8,8,1349,48,306744,207,308348
8192,8,16,8,8,1376,48,306680,182,308286
8192,8,16,8,8,1385,49,307369,350,309153
8192,8,16,8,8,1374,48,305927,226,307575
8192,8,16,8,8,1384,48,306673,232,308337
8192,8,16,8,8,1598,53,307050,170,308871
8192,16,8,8,8,1356,99,305985,176,307616
8192,16,8,8,8,1350,49,306458,197,308054
8192,16,8,8,8,1386,60,306965,189,308600
8192,16,8,8,8,1394,49,306871,1235,309549
8192,16,8,8,8,1490,71,307020,174,308755
8192,16,8,8,8,1350,48,306798,204,308400
8192,16,8,8,8,1509,92,306849,222,308672
8192,16,8,8,8,1406,64,307163,192,308825
8192,16,8,8,8,2134,109,306050,174,308467
8192,16,8,8,8,1533,50,307306,184,309073
8192,32,4,8,8,1443,64,307084,171,308762
8192,32,4,8,8,2761,85,306318,187,309351
8192,32,4,8,8,1505,102,306523,195,308325
8192,32,4,8,8,1399,48,306152,225,307824
8192,32,4,8,8,1349,47,307092,196,308684
8192,32,4,8,8,1350,49,306120,162,307681
8192,32,4,8,8,1388,76,306201,181,307846
8192,32,4,8,8,1502,56,306580,248,308386
8192,32,4,8,8,1350,51,306232,174,307807
8192,32,4,8,8,1384,49,307331,175,308939
8192,64,2,8,8,1350,48,306373,176,307947
8192,64,2,8,8,1413,49,306251,166,307879
8192,64,2,8,8,1398,50,307320,188,308956
8192,64,2,8,8,1350,49,306274,172,307845
8192,64,2,8,8,1401,53,306167,177,307798
8192,64,2,8,8,1396,62,307016,176,308650
8192,64,2,8,8,1424,113,305164,190,306891
8192,64,2,8,8,1396,49,304971,203,306619
8192,64,2,8,8,1422,51,306303,196,307972
8192,64,2,8,8,1351,49,305234,168,306802
8192,128,1,8,8,1478,89,307009,175,308751
8192,128,1,8,8,1349,47,307127,506,309029
8192,128,1,8,8,1349,47,305002,207,306605
8192,128,1,8,8,1391,66,307630,173,309260
8192,128,1,8,8,1532,186,306913,172,308803
8192,128,1,8,8,1384,48,306754,1564,309750
8192,128,1,8,8,1423,56,307068,1296,309843
8192,128,1,8,8,1421,62,307244,180,308907
8192,128,1,8,8,1386,59,306637,185,308267
8192,128,1,8,8,1387,48,307012,209,308656
8192,1,256,4,8,1365,50,329144,332,330891
8192,1,256,4,8,1478,52,329218,178,330926
8192,1,256,4,8,1350,47,329825,177,331399
8192,1,256,4,8,1395,49,328935,168,330547
8192,1,256,4,8,2249,100,329836,222,332407
8192,1,256,4,8,1385,48,330082,181,331696
8192,1,256,4,8,1349,48,329719,378,331494
8192,1,256,4,8,1394,48,330945,178,332565
8192,1,256,4,8,1402,49,330196,168,331815
8192,1,256,4,8,1349,47,330421,169,331986
8192,2,128,4,8,1413,68,330198,237,331916
8192,2,128,4,8,2484,62,330269,199,333014
8192,2,128,4,8,1459,65,329431,175,331130
8192,2,128,4,8,1426,67,329592,172,331257
8192,2,128,4,8,1351,49,329593,232,331225
8192,2,128,4,8,1402,48,330579,205,332234
8192,2,128,4,8,2028,52,330336,205,332621
8192,2,128,4,8,1384,51,330891,202,332528
8192,2,128,4,8,1388,50,330124,175,331737
8192,2,128,4,8,1367,49,330350,176,331942
8192,4,64,4,8,1400,60,329934,187,331581
8192,4,64,4,8,1455,77,330135,212,331879
8192,4,64,4,8,1403,67,330042,183,331695
8192,4,64,4,8,1410,62,329208,234,330914
8192,4,64,4,8,1484,64,329140,229,330917
8192,4,64,4,8,1353,49,328996,167,330565
8192,4,64,4,8,1349,47,330136,177,331709
8192,4,64,4,8,1801,48,330182,186,332217
8192,4,64,4,8,1383,88,330061,193,331725
8192,4,64,4,8,1355,70,330222,202,331849
8192,8,32,4,8,1438,95,330093,170,331796
8192,8,32,4,8,1493,139,330023,176,331831
8192,8,32,4,8,1360,69,328767,208,330404
8192,8,32,4,8,1942,49,328964,180,331135
8192,8,32,4,8,1350,113,330958,174,332595
8192,8,32,4,8,1407,59,328662,3216,333344
8192,8,32,4,8,1739,60,331199,238,333236
8192,8,32,4,8,1349,48,329829,177,331403
8192,8,32,4,8,1717,63,330216,180,332176
8192,8,32,4,8,1386,56,330024,214,331680
8192,16,16,4,8,1418,48,331039,187,332692
8192,16,16,4,8,2192,98,328997,193,331480
8192,16,16,4,8,1432,85,328704,167,330388
8192,16,16,4,8,1358,49,329777,182,331366
8192,16,16,4,8,1349,47,329729,172,331297
8192,16,16,4,8,1442,59,329674,181,331356
8192,16,16,4,8,1369,48,329804,176,331397
8192,16,16,4,8,1354,60,329874,179,331467
8192,16,16,4,8,2009,50,328912,525,331496
8192,16,16,4,8,1350,47,330124,176,331697
8192,32,8,4,8,1470,50,329807,191,331518
8192,32,8,4,8,1717,105,328628,180,330630
8192,32,8,4,8,1677,59,329041,291,331068
8192,32,8,4,8,1887,128,329513,177,331705
8192,32,8,4,8,1350,47,328752,172,330321
8192,32,8,4,8,1397,49,330509,175,332130
8192,32,8,4,8,1349,48,329919,183,331499
8192,32,8,4,8,1443,139,329886,175,331643
8192,32,8,4,8,1403,65,329840,184,331492
8192,32,8,4,8,1652,75,330075,472,332274
8192,64,4,4,8,1387,52,328925,191,330555
8192,64,4,4,8,1523,82,328619,212,330436
8192,64,4,4,8,1357,75,328852,176,330460
8192,64,4,4,8,1351,49,329793,171,331364
8192,64,4,4,8,1349,49,329504,209,331111
8192,64,4,4,8,1425,49,330406,182,332062
8192,64,4,4,8,1355,48,329916,171,331490
8192,64,4,4,8,1385,48,330291,197,331921
8192,64,4,4,8,1695,68,329873,227,331863
8192,64,4,4,8,1400,53,330465,291,332209
8192,128,2,4,8,2171,62,328250,178,330661
8192,128,2,4,8,1349,48,328689,176,330262
8192,128,2,4,8,1384,48,329475,172,331079
8192,128,2,4,8,1851,87,329513,2874,334325
8192,128,2,4,8,1349,48,330900,188,332485
8192,128,2,4,8,1584,96,329770,184,331634
8192,128,2,4,8,1811,68,329838,199,331916
8192,128,2,4,8,1358,84,329948,189,331579
8192,128,2,4,8,1384,48,330572,169,332173
8192,128,2,4,8,1461,90,328192,177,329920
8192,256,1,4,8,1393,50,330330,174,331947
8192,256,1,4,8,1492,52,328808,198,330550
8192,256,1,4,8,1408,50,330818,183,332459
8192,256,1,4,8,1440,49,329795,205,331489
8192,256,1,4,8,1368,51,331256,175,332850
8192,256,1,4,8,1350,47,330583,172,332152
8192,256,1,4,8,1415,49,330010,174,331648
8192,256,1,4,8,1398,61,329872,185,331516
8192,256,1,4,8,2014,70,330743,180,333007
8192,256,1,4,8,1397,49,329808,178,331432
