32,1,32,1,1,6,24,1119,138,1287
32,1,32,1,1,8,25,1119,136,1288
32,1,32,1,1,6,23,1115,77,1221
32,1,32,1,1,8,24,1119,171,1322
32,1,32,1,1,6,23,1116,108,1253
32,1,32,1,1,6,22,1115,78,1221
32,1,32,1,1,6,23,1116,96,1241
32,1,32,1,1,6,25,1121,149,1301
32,1,32,1,1,6,27,1119,114,1266
32,1,32,1,1,6,23,1115,79,1223
32,2,16,1,1,6,25,1138,114,1283
32,2,16,1,1,6,24,1134,83,1247
32,2,16,1,1,6,23,1133,93,1255
32,2,16,1,1,8,26,1134,86,1254
32,2,16,1,1,5,23,1133,96,1257
32,2,16,1,1,8,29,1139,111,1287
32,2,16,1,1,6,22,1132,79,1239
32,2,16,1,1,6,26,1136,114,1282
32,2,16,1,1,5,22,1133,76,1236
32,2,16,1,1,5,23,1132,77,1237
32,4,8,1,1,10,29,1152,110,1301
32,4,8,1,1,10,29,1151,110,1300
32,4,8,1,1,5,24,1149,86,1264
32,4,8,1,1,5,22,1147,73,1247
32,4,8,1,1,5,22,1148,74,1249
32,4,8,1,1,6,23,1157,235,1421
32,4,8,1,1,9,27,1150,114,1300
32,4,8,1,1,6,23,1148,78,1255
32,4,8,1,1,6,22,1148,74,1250
32,4,8,1,1,6,22,1147,96,1271
32,8,4,1,1,5,73,1181,79,1338
32,8,4,1,1,5,22,1178,94,1299
32,8,4,1,1,6,23,1180,90,1299
32,8,4,1,1,5,24,1178,81,1288
32,8,4,1,1,6,22,1179,81,1288
32,8,4,1,1,8,25,1182,121,1336
32,8,4,1,1,6,22,1177,78,1283
32,8,4,1,1,6,25,1180,95,1306
32,8,4,1,1,6,23,1178,73,1280
32,8,4,1,1,5,22,1178,75,1280
32,16,2,1,1,6,23,1243,172,1444
32,16,2,1,1,6,23,1241,81,1351
32,16,2,1,1,5,22,1238,74,1339
32,16,2,1,1,6,22,1239,73,1340
32,16,2,1,1,5,22,1239,80,1346
32,16,2,1,1,5,23,1239,79,1346
32,16,2,1,1,6,25,1242,137,1410
32,16,2,1,1,5,23,1240,82,1350
32,16,2,1,1,5,22,1242,75,1344
32,16,2,1,1,6,22,1238,74,1340
32,32,1,1,1,5,22,1363,73,1463
32,32,1,1,1,5,23,1369,143,1540
32,32,1,1,1,6,23,1364,119,1512
32,32,1,1,1,6,23,1364,78,1471
32,32,1,1,1,8,23,1363,77,1471
32,32,1,1,1,5,21,1432,74,1532
32,32,1,1,1,6,25,1369,130,1530
32,32,1,1,1,6,24,1371,107,1508
32,32,1,1,1,10,28,1367,106,1511
32,32,1,1,1,5,22,1363,79,1469
32,1,64,1,1,6,23,1127,75,1231
32,1,64,1,1,5,22,1126,73,1226
32,1,64,1,1,5,23,1127,74,1229
32,1,64,1,1,5,22,1127,74,1228
32,1,64,1,1,9,24,1129,85,1247
32,1,64,1,1,9,28,1130,86,1253
32,1,64,1,1,5,22,1127,74,1228
32,1,64,1,1,5,22,1126,74,1227
32,1,64,1,1,5,22,1127,72,1226
32,1,64,1,1,6,22,1126,74,1228
32,2,32,1,1,6,22,1144,74,1246
32,2,32,1,1,5,22,1148,79,1254
32,2,32,1,1,6,22,1144,74,1246
32,2,32,1,1,5,22,1145,76,1248
32,2,32,1,1,6,26,1153,110,1295
32,2,32,1,1,6,22,1145,76,1249
32,2,32,1,1,6,23,1145,85,1259
32,2,32,1,1,5,22,1148,79,1254
32,2,32,1,1,6,23,1144,77,1250
32,2,32,1,1,9,27,1149,114,1299
32,4,16,1,1,9,30,1168,166,1373
32,4,16,1,1,7,24,1162,105,1298
32,4,16,1,1,5,23,1165,80,1273
32,4,16,1,1,5,23,1159,76,1263
32,4,16,1,1,5,22,1159,72,1258
32,4,16,1,1,6,23,1160,76,1265
32,4,16,1,1,5,22,1159,74,1260
32,4,16,1,1,5,23,1170,101,1299
32,4,16,1,1,6,24,1161,81,1272
32,4,16,1,1,6,23,1160,75,1264
32,8,8,1,1,6,22,1190,74,1292
32,8,8,1,1,5,22,1190,77,1294
32,8,8,1,1,5,23,1190,73,1291
32,8,8,1,1,6,25,1191,95,1317
32,8,8,1,1,5,23,1191,90,1309
32,8,8,1,1,5,22,1190,73,1290
32,8,8,1,1,5,22,1190,73,1290
32,8,8,1,1,5,22,1191,74,1292
32,8,8,1,1,6,25,1196,181,1408
32,8,8,1,1,6,24,1193,128,1351
32,16,4,1,1,6,25,1252,89,1372
32,16,4,1,1,6,22,1252,88,1368
32,16,4,1,1,5,22,1250,77,1354
32,16,4,1,1,5,23,1251,76,1355
32,16,4,1,1,5,22,1251,74,1352
32,16,4,1,1,6,22,1251,73,1352
32,16,4,1,1,5,22,1251,72,1350
32,16,4,1,1,5,23,1279,178,1485
32,16,4,1,1,5,24,1251,94,1374
32,16,4,1,1,5,24,1252,100,1381
32,32,2,1,1,8,25,1373,100,1506
32,32,2,1,1,6,22,1373,75,1476
32,32,2,1,1,19,22,1372,73,1486
32,32,2,1,1,6,22,1372,73,1473
32,32,2,1,1,5,22,1373,115,1515
32,32,2,1,1,6,35,1394,135,1570
32,32,2,1,1,6,24,1373,107,1510
32,32,2,1,1,6,23,1372,78,1479
32,32,2,1,1,5,23,1373,78,1479
32,32,2,1,1,6,22,1372,78,1478
32,64,1,1,1,6,22,1363,128,1519
32,64,1,1,1,5,22,1368,182,1577
32,64,1,1,1,6,24,1373,130,1533
32,64,1,1,1,6,26,1385,106,1523
32,64,1,1,1,6,24,1364,84,1478
32,64,1,1,1,5,23,1363,110,1501
32,64,1,1,1,5,22,1362,72,1461
32,64,1,1,1,6,22,1363,74,1465
32,64,1,1,1,5,22,1363,81,1471
32,64,1,1,1,6,24,1368,155,1553
32,1,128,1,1,5,24,1116,125,1270
32,1,128,1,1,6,24,1121,117,1268
32,1,128,1,1,5,22,1112,76,1215
32,1,128,1,1,5,23,1112,74,1214
32,1,128,1,1,5,22,1116,74,1217
32,1,128,1,1,5,24,1113,94,1236
32,1,128,1,1,6,23,1112,74,1215
32,1,128,1,1,5,23,1136,310,1474
32,1,128,1,1,6,23,1113,79,1221
32,1,128,1,1,5,22,1112,77,1216
32,2,64,1,1,5,22,1130,73,1230
32,2,64,1,1,5,21,1134,73,1233
32,2,64,1,1,5,22,1130,78,1235
32,2,64,1,1,7,29,1135,93,1264
32,2,64,1,1,7,29,1134,107,1277
32,2,64,1,1,6,22,1133,165,1326
32,2,64,1,1,7,29,1136,180,1352
32,2,64,1,1,5,23,1131,77,1236
32,2,64,1,1,5,22,1130,86,1243
32,2,64,1,1,5,22,1130,76,1233
32,4,32,1,1,5,22,1145,78,1250
32,4,32,1,1,6,22,1145,72,1245
32,4,32,1,1,6,22,1146,74,1248
32,4,32,1,1,6,22,1145,74,1247
32,4,32,1,1,5,22,1146,74,1247
32,4,32,1,1,6,36,1151,130,1323
32,4,32,1,1,5,24,1147,80,1256
32,4,32,1,1,10,28,1150,90,1278
32,4,32,1,1,6,22,1147,81,1256
32,4,32,1,1,5,22,1149,74,1250
32,8,16,1,1,6,41,1191,130,1368
32,8,16,1,1,5,23,1176,87,1291
32,8,16,1,1,5,22,1176,146,1349
32,8,16,1,1,5,22,1176,72,1275
32,8,16,1,1,5,22,1176,75,1278
32,8,16,1,1,5,22,1176,73,1276
32,8,16,1,1,5,24,1181,178,1388
32,8,16,1,1,6,25,1200,106,1337
32,8,16,1,1,5,23,1176,78,1282
32,8,16,1,1,5,22,1176,75,1278
32,16,8,1,1,5,22,1237,100,1364
32,16,8,1,1,7,31,1251,158,1447
32,16,8,1,1,6,25,1239,86,1356
32,16,8,1,1,6,26,1239,91,1362
32,16,8,1,1,5,22,1237,76,1340
32,16,8,1,1,6,23,1237,74,1340
32,16,8,1,1,6,23,1238,82,1349
32,16,8,1,1,10,38,1249,150,1447
32,16,8,1,1,5,23,1237,76,1341
32,16,8,1,1,6,22,1238,75,1341
32,32,4,1,1,6,29,1369,101,1505
32,32,4,1,1,7,30,1377,149,1563
32,32,4,1,1,8,24,1368,82,1482
32,32,4,1,1,6,22,1367,119,1514
32,32,4,1,1,5,22,1367,73,1467
32,32,4,1,1,5,22,1367,84,1478
32,32,4,1,1,5,23,1377,157,1562
32,32,4,1,1,6,23,1368,83,1480
32,32,4,1,1,6,23,1368,77,1474
32,32,4,1,1,9,25,1381,91,1506
32,64,2,1,1,5,22,1365,73,1465
32,64,2,1,1,5,22,1365,73,1465
32,64,2,1,1,6,22,1364,74,1466
32,64,2,1,1,6,22,1375,148,1551
32,64,2,1,1,6,23,1366,84,1479
32,64,2,1,1,5,23,1369,79,1476
32,64,2,1,1,5,22,1365,80,1472
32,64,2,1,1,5,22,1365,153,1545
32,64,2,1,1,5,21,1364,74,1464
32,64,2,1,1,5,22,1370,75,1472
32,128,1,1,1,6,24,1369,125,1524
32,128,1,1,1,6,23,1366,110,1505
32,128,1,1,1,8,23,1363,74,1468
32,128,1,1,1,5,22,1363,77,1467
32,128,1,1,1,6,22,1362,76,1466
32,128,1,1,1,5,23,1363,83,1474
32,128,1,1,1,6,24,1366,117,1513
32,128,1,1,1,6,24,1363,82,1475
32,128,1,1,1,9,25,1368,85,1487
32,128,1,1,1,5,22,1363,76,1466
32,1,256,1,1,5,22,1128,73,1228
32,1,256,1,1,5,23,1129,74,1231
32,1,256,1,1,5,22,1128,75,1230
32,1,256,1,1,9,30,1135,130,1304
32,1,256,1,1,5,22,1128,100,1255
32,1,256,1,1,5,22,1128,74,1229
32,1,256,1,1,5,22,1131,73,1231
32,1,256,1,1,5,22,1127,72,1226
32,1,256,1,1,5,22,1128,123,1278
32,1,256,1,1,6,22,1128,97,1253
32,2,128,1,1,5,23,1147,90,1265
32,2,128,1,1,6,70,1147,94,1317
32,2,128,1,1,5,22,1146,73,1246
32,2,128,1,1,5,22,1146,76,1249
32,2,128,1,1,5,22,1145,76,1248
32,2,128,1,1,6,62,1147,95,1310
32,2,128,1,1,6,23,1146,83,1258
32,2,128,1,1,6,23,1146,79,1254
32,2,128,1,1,6,24,1148,99,1277
32,2,128,1,1,6,23,1145,86,1260
32,4,64,1,1,5,22,1163,73,1263
32,4,64,1,1,6,22,1168,202,1398
32,4,64,1,1,8,25,1164,93,1290
32,4,64,1,1,5,22,1163,74,1264
32,4,64,1,1,6,22,1162,73,1263
32,4,64,1,1,8,23,1163,77,1271
32,4,64,1,1,5,23,1163,93,1284
32,4,64,1,1,6,25,1164,94,1289
32,4,64,1,1,6,23,1163,77,1269
32,4,64,1,1,6,22,1162,80,1270
32,8,32,1,1,6,22,1195,77,1300
32,8,32,1,1,5,22,1196,75,1298
32,8,32,1,1,6,26,1205,146,1383
32,8,32,1,1,6,24,1197,87,1314
32,8,32,1,1,5,22,1195,77,1299
32,8,32,1,1,5,22,1195,75,1297
32,8,32,1,1,6,21,1194,74,1295
32,8,32,1,1,5,22,1195,73,1295
32,8,32,1,1,5,22,1195,76,1298
32,8,32,1,1,6,26,1201,113,1346
32,16,16,1,1,6,22,1263,96,1387
32,16,16,1,1,5,23,1261,77,1366
32,16,16,1,1,5,22,1261,79,1367
32,16,16,1,1,6,22,1277,155,1460
32,16,16,1,1,7,34,1270,168,1479
32,16,16,1,1,8,33,1272,121,1434
32,16,16,1,1,5,23,1262,78,1368
32,16,16,1,1,10,31,1268,135,1444
32,16,16,1,1,5,22,1262,74,1363
32,16,16,1,1,10,30,1271,210,1521
32,32,8,1,1,6,25,1423,156,1610
32,32,8,1,1,5,22,1415,84,1526
32,32,8,1,1,5,26,1415,76,1522
32,32,8,1,1,5,22,1415,75,1517
32,32,8,1,1,8,23,1415,75,1521
32,32,8,1,1,6,22,1416,77,1521
32,32,8,1,1,7,22,1415,74,1518
32,32,8,1,1,5,32,1440,74,1551
32,32,8,1,1,6,22,1415,74,1517
32,32,8,1,1,5,22,1416,86,1529
32,64,4,1,1,8,25,1382,105,1520
32,64,4,1,1,5,23,1382,87,1497
32,64,4,1,1,8,25,1381,87,1501
32,64,4,1,1,5,23,1380,80,1488
32,64,4,1,1,6,23,1380,93,1502
32,64,4,1,1,6,22,1380,75,1483
32,64,4,1,1,6,22,1380,76,1484
32,64,4,1,1,5,22,1380,76,1483
32,64,4,1,1,5,22,1380,73,1480
32,64,4,1,1,5,22,1380,73,1480
32,128,2,1,1,50,23,1370,91,1534
32,128,2,1,1,5,23,1372,132,1532
32,128,2,1,1,5,27,1375,88,1495
32,128,2,1,1,6,23,1371,88,1488
32,128,2,1,1,5,22,1371,76,1474
32,128,2,1,1,5,22,1370,75,1472
32,128,2,1,1,5,22,1369,73,1469
32,128,2,1,1,5,22,1369,76,1472
32,128,2,1,1,5,23,1370,76,1474
32,128,2,1,1,5,23,1371,92,1491
32,256,1,1,1,6,26,1366,115,1513
32,256,1,1,1,6,25,1363,97,1491
32,256,1,1,1,5,23,1364,109,1501
32,256,1,1,1,6,23,1362,78,1469
32,256,1,1,1,6,22,1363,79,1470
32,256,1,1,1,5,22,1363,83,1473
32,256,1,1,1,5,22,1363,94,1484
32,256,1,1,1,6,32,1367,121,1526
32,256,1,1,1,5,24,1364,98,1491
32,256,1,1,1,5,23,1364,80,1472
64,1,32,2,1,11,22,2435,75,2543
64,1,32,2,1,11,22,2435,78,2546
64,1,32,2,1,11,23,2436,129,2599
64,1,32,2,1,11,23,2435,80,2549
64,1,32,2,1,11,26,2435,77,2549
64,1,32,2,1,11,22,2435,75,2543
64,1,32,2,1,11,21,2435,75,2542
64,1,32,2,1,11,22,2433,81,2547
64,1,32,2,1,11,22,2435,129,2597
64,1,32,2,1,11,23,2439,96,2569
64,2,16,2,1,11,23,2436,80,2550
64,2,16,2,1,11,21,2437,137,2606
64,2,16,2,1,11,23,2437,144,2615
64,2,16,2,1,11,23,2442,83,2559
64,2,16,2,1,11,22,2436,76,2545
64,2,16,2,1,11,24,2435,90,2560
64,2,16,2,1,11,23,2436,77,2547
64,2,16,2,1,11,31,2436,124,2602
64,2,16,2,1,11,21,2434,77,2543
64,2,16,2,1,11,21,2434,82,2548
64,4,8,2,1,11,22,2436,88,2557
64,4,8,2,1,16,25,2437,133,2611
64,4,8,2,1,14,24,2437,85,2560
64,4,8,2,1,11,24,2440,138,2613
64,4,8,2,1,16,34,2444,157,2651
64,4,8,2,1,11,21,2436,74,2542
64,4,8,2,1,11,23,2440,138,2612
64,4,8,2,1,16,25,2437,105,2583
64,4,8,2,1,11,22,2435,76,2544
64,4,8,2,1,11,22,2435,75,2543
64,8,4,2,1,11,22,2434,81,2548
64,8,4,2,1,11,24,2437,135,2607
64,8,4,2,1,11,21,2434,74,2540
64,8,4,2,1,11,23,2433,81,2548
64,8,4,2,1,19,31,2438,143,2631
64,8,4,2,1,11,22,2436,120,2589
64,8,4,2,1,11,23,2437,76,2547
64,8,4,2,1,11,23,2434,73,2541
64,8,4,2,1,11,21,2434,74,2540
64,8,4,2,1,11,22,2433,77,2543
64,16,2,2,1,11,23,2437,138,2609
64,16,2,2,1,17,44,2457,176,2694
64,16,2,2,1,11,24,2437,96,2568
64,16,2,2,1,11,22,2435,103,2571
64,16,2,2,1,11,24,2437,124,2596
64,16,2,2,1,11,24,2435,127,2597
64,16,2,2,1,12,25,2436,89,2562
64,16,2,2,1,11,22,2435,80,2548
64,16,2,2,1,11,22,2433,87,2553
64,16,2,2,1,11,22,2441,235,2709
64,32,1,2,1,11,21,2447,128,2607
64,32,1,2,1,11,22,2445,78,2556
64,32,1,2,1,11,22,2445,76,2554
64,32,1,2,1,11,22,2445,74,2552
64,32,1,2,1,11,22,2445,87,2565
64,32,1,2,1,11,22,2460,180,2673
64,32,1,2,1,11,27,2450,130,2618
64,32,1,2,1,11,23,2447,123,2604
64,32,1,2,1,11,22,2444,77,2554
64,32,1,2,1,11,22,2445,75,2553
64,1,64,1,1,11,22,2219,76,2328
64,1,64,1,1,11,22,2217,136,2386
64,1,64,1,1,11,22,2218,149,2400
64,1,64,1,1,12,26,2222,129,2389
64,1,64,1,1,11,24,2219,96,2350
64,1,64,1,1,11,22,2217,79,2329
64,1,64,1,1,11,23,2215,77,2326
64,1,64,1,1,11,22,2216,74,2323
64,1,64,1,1,11,22,2221,383,2637
64,1,64,1,1,11,24,2218,121,2374
64,2,32,1,1,11,27,2237,116,2391
64,2,32,1,1,11,23,2239,90,2363
64,2,32,1,1,11,22,2236,113,2382
64,2,32,1,1,11,23,2236,131,2401
64,2,32,1,1,11,23,2235,77,2346
64,2,32,1,1,11,24,2234,75,2344
64,2,32,1,1,11,22,2233,73,2339
64,2,32,1,1,11,22,2234,79,2346
64,2,32,1,1,11,21,2237,184,2453
64,2,32,1,1,11,23,2237,138,2409
64,4,16,1,1,11,23,2249,103,2386
64,4,16,1,1,11,23,2249,78,2361
64,4,16,1,1,11,22,2249,75,2357
64,4,16,1,1,11,23,2247,76,2357
64,4,16,1,1,11,22,2249,100,2382
64,4,16,1,1,11,24,2253,161,2449
64,4,16,1,1,13,48,2271,132,2464
64,4,16,1,1,11,24,2251,93,2379
64,4,16,1,1,11,22,2248,76,2357
64,4,16,1,1,11,22,2248,74,2355
64,8,8,1,1,11,21,2278,77,2387
64,8,8,1,1,11,22,2280,85,2398
64,8,8,1,1,11,22,2290,127,2450
64,8,8,1,1,11,25,2284,132,2452
64,8,8,1,1,11,22,2280,77,2390
64,8,8,1,1,11,22,2279,74,2386
64,8,8,1,1,11,21,2279,75,2386
64,8,8,1,1,11,22,2279,75,2387
64,8,8,1,1,11,22,2283,177,2493
64,8,8,1,1,12,36,2292,165,2505
64,16,4,1,1,11,22,2341,108,2482
64,16,4,1,1,11,22,2344,76,2453
64,16,4,1,1,11,22,2339,76,2448
64,16,4,1,1,11,22,2366,130,2529
64,16,4,1,1,11,24,2341,84,2460
64,16,4,1,1,11,25,2344,131,2511
64,16,4,1,1,11,24,2343,175,2553
64,16,4,1,1,11,22,2340,75,2448
64,16,4,1,1,11,22,2340,74,2447
64,16,4,1,1,11,22,2341,207,2581
64,32,2,1,1,11,25,2461,88,2585
64,32,2,1,1,11,21,2462,74,2568
64,32,2,1,1,11,22,2462,76,2571
64,32,2,1,1,11,22,2463,88,2584
64,32,2,1,1,11,22,2462,73,2568
64,32,2,1,1,11,22,2461,74,2568
64,32,2,1,1,11,32,2470,195,2708
64,32,2,1,1,11,23,2462,79,2575
64,32,2,1,1,11,23,2462,77,2573
64,32,2,1,1,11,22,2461,74,2568
64,64,1,1,1,11,22,2443,129,2605
64,64,1,1,1,16,28,2448,149,2641
64,64,1,1,1,11,23,2442,87,2563
64,64,1,1,1,11,24,2443,80,2558
64,64,1,1,1,11,22,2441,78,2552
64,64,1,1,1,11,22,2441,76,2550
64,64,1,1,1,11,22,2443,140,2616
64,64,1,1,1,11,26,2449,132,2618
64,64,1,1,1,11,25,2447,158,2641
64,64,1,1,1,11,21,2442,77,2551
64,1,128,1,1,11,23,2188,76,2298
64,1,128,1,1,11,23,2234,74,2342
64,1,128,1,1,11,22,2189,113,2335
64,1,128,1,1,11,23,2189,82,2305
64,1,128,1,1,11,23,2188,79,2301
64,1,128,1,1,11,24,2189,108,2332
64,1,128,1,1,11,22,2188,80,2301
64,1,128,1,1,11,22,2188,77,2298
64,1,128,1,1,11,23,2191,139,2364
64,1,128,1,1,11,23,2190,126,2350
64,2,64,1,1,11,22,2206,119,2358
64,2,64,1,1,11,22,2205,122,2360
64,2,64,1,1,11,24,2214,182,2431
64,2,64,1,1,11,24,2208,99,2342
64,2,64,1,1,11,24,2206,80,2321
64,2,64,1,1,11,22,2205,77,2315
64,2,64,1,1,11,23,2204,126,2364
64,2,64,1,1,11,22,2207,101,2341
64,2,64,1,1,11,27,2211,140,2389
64,2,64,1,1,11,22,2206,84,2323
64,4,32,1,1,11,21,2222,116,2370
64,4,32,1,1,24,33,2231,181,2469
64,4,32,1,1,11,24,2227,171,2433
64,4,32,1,1,11,23,2221,94,2349
64,4,32,1,1,11,22,2223,102,2358
64,4,32,1,1,11,22,2221,77,2331
64,4,32,1,1,11,22,2221,74,2328
64,4,32,1,1,11,21,2222,77,2331
64,4,32,1,1,11,23,2223,123,2380
64,4,32,1,1,11,22,2221,109,2363
64,8,16,1,1,11,22,2253,115,2401
64,8,16,1,1,11,22,2259,79,2371
64,8,16,1,1,11,22,2251,75,2359
64,8,16,1,1,11,21,2250,75,2357
64,8,16,1,1,11,22,2251,90,2374
64,8,16,1,1,16,25,2252,113,2406
64,8,16,1,1,11,23,2252,93,2379
64,8,16,1,1,11,21,2251,76,2359
64,8,16,1,1,11,22,2251,77,2361
64,8,16,1,1,11,22,2251,77,2361
64,16,8,1,1,13,24,2316,189,2542
64,16,8,1,1,11,24,2314,89,2438
64,16,8,1,1,11,22,2312,78,2423
64,16,8,1,1,11,22,2312,76,2421
64,16,8,1,1,12,28,2321,142,2503
64,16,8,1,1,11,23,2313,79,2426
64,16,8,1,1,11,21,2311,76,2419
64,16,8,1,1,11,22,2313,76,2422
64,16,8,1,1,11,23,2331,158,2523
64,16,8,1,1,11,24,2315,89,2439
64,32,4,1,1,11,22,2441,75,2549
64,32,4,1,1,11,22,2444,79,2556
64,32,4,1,1,11,22,2443,87,2563
64,32,4,1,1,11,24,2446,111,2592
64,32,4,1,1,13,32,2457,130,2632
64,32,4,1,1,11,23,2443,83,2560
64,32,4,1,1,11,21,2442,74,2548
64,32,4,1,1,11,22,2442,79,2554
64,32,4,1,1,16,26,2449,169,2660
64,32,4,1,1,11,24,2444,91,2570
64,64,2,1,1,11,31,2460,127,2629
64,64,2,1,1,11,23,2459,79,2572
64,64,2,1,1,16,26,2461,146,2649
64,64,2,1,1,11,23,2456,90,2580
64,64,2,1,1,11,21,2455,76,2563
64,64,2,1,1,11,21,2455,75,2562
64,64,2,1,1,11,21,2477,207,2716
64,64,2,1,1,11,23,2457,95,2586
64,64,2,1,1,11,22,2458,131,2622
64,64,2,1,1,11,22,2455,77,2565
64,128,1,1,1,11,22,2442,76,2551
64,128,1,1,1,11,23,2445,148,2627
64,128,1,1,1,24,22,2444,157,2647
64,128,1,1,1,11,24,2445,137,2617
64,128,1,1,1,17,25,2444,84,2570
64,128,1,1,1,11,23,2442,77,2553
64,128,1,1,1,11,22,2442,78,2553
64,128,1,1,1,17,33,2451,163,2664
64,128,1,1,1,11,22,2442,85,2560
64,128,1,1,1,11,23,2443,83,2560
64,1,256,1,1,17,24,2215,87,2343
64,1,256,1,1,11,23,2215,77,2326
64,1,256,1,1,11,23,2219,147,2400
64,1,256,1,1,11,24,2215,94,2344
64,1,256,1,1,11,22,2214,73,2320
64,1,256,1,1,11,21,2216,131,2379
64,1,256,1,1,12,27,2230,131,2400
64,1,256,1,1,11,23,2214,94,2342
64,1,256,1,1,11,21,2214,73,2319
64,1,256,1,1,11,30,2233,74,2348
64,2,128,1,1,11,22,2231,74,2338
64,2,128,1,1,16,34,2239,131,2420
64,2,128,1,1,11,24,2234,116,2385
64,2,128,1,1,11,22,2231,78,2342
64,2,128,1,1,11,22,2232,80,2345
64,2,128,1,1,11,25,2237,134,2407
64,2,128,1,1,11,23,2232,82,2348
64,2,128,1,1,11,23,2230,79,2343
64,2,128,1,1,11,22,2232,76,2341
64,2,128,1,1,11,22,2232,180,2445
64,4,64,1,1,11,24,2251,105,2391
64,4,64,1,1,11,23,2248,81,2363
64,4,64,1,1,11,22,2249,78,2360
64,4,64,1,1,11,23,2254,189,2477
64,4,64,1,1,11,24,2249,90,2374
64,4,64,1,1,11,23,2248,78,2360
64,4,64,1,1,11,22,2249,167,2449
64,4,64,1,1,11,24,2252,144,2431
64,4,64,1,1,11,22,2251,125,2409
64,4,64,1,1,11,20,2248,78,2357
64,8,32,1,1,11,22,2282,78,2393
64,8,32,1,1,11,22,2286,170,2489
64,8,32,1,1,15,32,2294,138,2479
64,8,32,1,1,11,24,2283,83,2401
64,8,32,1,1,11,22,2282,79,2394
64,8,32,1,1,11,22,2282,77,2392
64,8,32,1,1,11,21,2281,77,2390
64,8,32,1,1,11,28,2313,191,2543
64,8,32,1,1,11,23,2281,88,2403
64,8,32,1,1,11,24,2291,163,2489
64,16,16,1,1,11,23,2348,81,2463
64,16,16,1,1,11,21,2351,74,2457
64,16,16,1,1,11,22,2349,83,2465
64,16,16,1,1,11,22,2348,85,2466
64,16,16,1,1,11,24,2348,88,2471
64,16,16,1,1,11,22,2348,99,2480
64,16,16,1,1,11,24,2350,123,2508
64,16,16,1,1,11,22,2351,74,2458
64,16,16,1,1,11,22,2346,73,2452
64,16,16,1,1,11,28,2357,139,2535
64,32,8,1,1,17,26,2504,97,2644
64,32,8,1,1,11,25,2502,77,2615
64,32,8,1,1,11,23,2504,122,2660
64,32,8,1,1,11,22,2501,78,2612
64,32,8,1,1,11,22,2504,147,2684
64,32,8,1,1,11,23,2504,83,2621
64,32,8,1,1,11,22,2502,77,2612
64,32,8,1,1,11,22,2502,75,2610
64,32,8,1,1,11,23,2506,163,2703
64,32,8,1,1,16,25,2502,94,2637
64,64,4,1,1,17,26,2501,115,2659
64,64,4,1,1,11,24,2503,81,2619
64,64,4,1,1,11,24,2501,142,2678
64,64,4,1,1,11,41,2500,122,2674
64,64,4,1,1,11,22,2498,79,2610
64,64,4,1,1,17,25,2504,142,2688
64,64,4,1,1,11,24,2498,80,2613
64,64,4,1,1,11,22,2502,86,2621
64,64,4,1,1,11,22,2498,85,2616
64,64,4,1,1,11,22,2498,79,2610
64,128,2,1,1,11,23,2475,78,2587
64,128,2,1,1,11,22,2474,79,2586
64,128,2,1,1,11,22,2468,73,2574
64,128,2,1,1,10,22,2470,79,2581
64,128,2,1,1,11,22,2471,92,2596
64,128,2,1,1,11,37,2474,158,2680
64,128,2,1,1,11,23,2471,109,2614
64,128,2,1,1,11,22,2472,95,2600
64,128,2,1,1,11,23,2468,76,2578
64,128,2,1,1,12,29,2470,80,2591
64,256,1,1,1,11,22,2441,75,2549
64,256,1,1,1,11,21,2442,74,2548
64,256,1,1,1,11,23,2443,91,2568
64,256,1,1,1,15,30,2449,156,2650
64,256,1,1,1,11,22,2442,77,2552
64,256,1,1,1,11,22,2443,78,2554
64,256,1,1,1,11,22,2442,77,2552
64,256,1,1,1,11,22,2445,184,2662
64,256,1,1,1,16,25,2444,101,2586
64,256,1,1,1,12,26,2449,143,2630
128,1,32,2,2,22,24,4613,121,4780
128,1,32,2,2,21,23,4614,89,4747
128,1,32,2,2,21,25,4616,116,4778
128,1,32,2,2,22,23,4613,100,4758
128,1,32,2,2,21,22,4615,101,4759
128,1,32,2,2,22,24,4615,87,4748
128,1,32,2,2,21,22,4614,73,4730
128,1,32,2,2,31,23,4619,135,4808
128,1,32,2,2,32,25,4615,89,4761
128,1,32,2,2,22,24,4617,102,4765
128,2,16,2,2,21,22,4616,132,4791
128,2,16,2,2,21,24,4615,134,4794
128,2,16,2,2,21,22,4607,78,4728
128,2,16,2,2,21,23,4613,119,4776
128,2,16,2,2,41,31,4620,177,4869
128,2,16,2,2,21,22,4613,130,4786
128,2,16,2,2,21,22,4610,74,4727
128,2,16,2,2,21,109,4608,77,4815
128,2,16,2,2,21,22,4635,166,4844
128,2,16,2,2,34,27,4620,114,4795
128,4,8,2,2,21,23,4622,123,4789
128,4,8,2,2,21,22,4607,95,4745
128,4,8,2,2,27,30,4620,138,4815
128,4,8,2,2,21,25,4606,89,4741
128,4,8,2,2,21,22,4612,76,4731
128,4,8,2,2,21,22,4617,126,4786
128,4,8,2,2,21,24,4614,83,4742
128,4,8,2,2,21,22,4609,74,4726
128,4,8,2,2,21,22,4620,131,4794
128,4,8,2,2,21,24,4614,132,4791
128,8,4,2,2,22,22,4610,94,4748
128,8,4,2,2,22,23,4615,141,4801
128,8,4,2,2,22,22,4606,80,4730
128,8,4,2,2,21,22,4608,73,4724
128,8,4,2,2,21,25,4614,116,4776
128,8,4,2,2,21,24,4610,79,4734
128,8,4,2,2,21,22,4612,73,4728
128,8,4,2,2,21,22,4618,244,4905
128,8,4,2,2,22,24,4619,139,4804
128,8,4,2,2,22,23,4613,83,4741
128,16,2,2,2,21,22,4612,81,4736
128,16,2,2,2,21,23,4615,124,4783
128,16,2,2,2,21,22,4610,74,4727
128,16,2,2,2,21,22,4618,149,4810
128,16,2,2,2,22,28,4618,113,4781
128,16,2,2,2,22,22,4613,75,4732
128,16,2,2,2,21,22,4611,175,4829
128,16,2,2,2,21,22,4615,132,4790
128,16,2,2,2,32,25,4616,122,4795
128,16,2,2,2,21,22,4611,75,4729
128,32,1,2,2,21,22,4625,93,4761
128,32,1,2,2,21,27,4628,94,4770
128,32,1,2,2,21,22,4624,79,4746
128,32,1,2,2,33,24,4627,136,4820
128,32,1,2,2,22,23,4628,185,4858
128,32,1,2,2,22,24,4628,121,4795
128,32,1,2,2,22,23,4625,123,4793
128,32,1,2,2,22,23,4626,98,4769
128,32,1,2,2,22,23,4628,145,4818
128,32,1,2,2,21,22,4624,78,4745
128,1,64,2,1,21,23,4578,97,4719
128,1,64,2,1,22,22,4572,76,4692
128,1,64,2,1,22,22,4572,101,4717
128,1,64,2,1,28,25,4580,145,4778
128,1,64,2,1,21,24,4568,80,4693
128,1,64,2,1,21,22,4573,81,4697
128,1,64,2,1,21,23,4573,138,4755
128,1,64,2,1,33,32,4585,140,4790
128,1,64,2,1,21,23,4574,81,4699
128,1,64,2,1,21,22,4572,75,4690
128,2,32,2,1,21,22,4576,146,4765
128,2,32,2,1,22,25,4575,113,4735
128,2,32,2,1,21,22,4571,90,4704
128,2,32,2,1,22,24,4576,137,4759
128,2,32,2,1,32,25,4571,90,4718
128,2,32,2,1,21,22,4568,151,4762
128,2,32,2,1,33,25,4568,125,4751
128,2,32,2,1,22,23,4566,81,4692
128,2,32,2,1,22,23,4564,108,4717
128,2,32,2,1,28,22,4568,128,4746
128,4,16,2,1,22,22,4568,84,4696
128,4,16,2,1,22,22,4574,164,4782
128,4,16,2,1,22,23,4577,101,4723
128,4,16,2,1,32,24,4570,207,4833
128,4,16,2,1,33,29,4571,114,4747
128,4,16,2,1,33,27,4570,131,4761
128,4,16,2,1,22,24,4575,148,4769
128,4,16,2,1,22,22,4575,166,4785
128,4,16,2,1,22,24,4573,131,4750
128,4,16,2,1,22,23,4575,93,4713
128,8,8,2,1,21,22,4578,75,4696
128,8,8,2,1,24,22,4579,80,4705
128,8,8,2,1,22,26,4573,115,4736
128,8,8,2,1,21,24,4575,88,4708
128,8,8,2,1,29,29,4580,230,4868
128,8,8,2,1,21,22,4581,155,4779
128,8,8,2,1,22,27,4585,123,4757
128,8,8,2,1,21,22,4572,77,4692
128,8,8,2,1,22,22,4578,136,4758
128,8,8,2,1,22,24,4574,97,4717
128,16,4,2,1,21,22,4568,74,4685
128,16,4,2,1,21,22,4576,213,4832
128,16,4,2,1,32,26,4583,115,4756
128,16,4,2,1,21,22,4575,120,4738
128,16,4,2,1,21,22,4577,133,4753
128,16,4,2,1,23,23,4571,100,4717
128,16,4,2,1,21,22,4574,78,4695
128,16,4,2,1,21,23,4583,133,4760
128,16,4,2,1,21,24,4576,108,4729
128,16,4,2,1,21,22,4578,74,4695
128,32,2,2,1,21,22,4635,137,4815
128,32,2,2,1,21,24,4634,108,4787
128,32,2,2,1,21,23,4632,129,4805
128,32,2,2,1,21,22,4648,219,4910
128,32,2,2,1,26,31,4638,122,4817
128,32,2,2,1,21,22,4631,77,4751
128,32,2,2,1,21,22,4636,169,4848
128,32,2,2,1,21,22,4629,77,4749
128,32,2,2,1,22,22,4632,144,4820
128,32,2,2,1,22,24,4634,128,4808
128,64,1,2,1,21,23,4608,79,4731
128,64,1,2,1,21,23,4609,139,4792
128,64,1,2,1,21,22,4613,147,4803
128,64,1,2,1,21,22,4603,81,4727
128,64,1,2,1,22,22,4616,302,4962
128,64,1,2,1,26,29,4614,123,4792
128,64,1,2,1,24,21,4611,75,4731
128,64,1,2,1,21,22,4611,185,4839
128,64,1,2,1,21,23,4610,86,4740
128,64,1,2,1,22,22,4612,157,4813
128,1,128,1,1,32,26,4340,123,4521
128,1,128,1,1,22,23,4334,126,4505
128,1,128,1,1,21,22,4333,105,4481
128,1,128,1,1,21,26,4333,96,4476
128,1,128,1,1,22,23,4333,105,4483
128,1,128,1,1,22,25,4339,132,4518
128,1,128,1,1,21,24,4334,80,4459
128,1,128,1,1,75,38,4334,118,4565
128,1,128,1,1,32,30,4335,121,4518
128,1,128,1,1,21,22,4332,83,4458
128,2,64,1,1,21,35,4364,126,4546
128,2,64,1,1,24,24,4354,154,4556
128,2,64,1,1,23,23,4355,83,4484
128,2,64,1,1,22,26,4354,114,4516
128,2,64,1,1,22,22,4350,77,4471
128,2,64,1,1,21,21,4351,113,4506
128,2,64,1,1,22,30,4358,122,4532
128,2,64,1,1,21,22,4350,75,4468
128,2,64,1,1,21,22,4353,129,4525
128,2,64,1,1,22,24,4354,118,4518
128,4,32,1,1,69,23,4369,126,4587
128,4,32,1,1,21,22,4370,224,4637
128,4,32,1,1,36,33,4370,134,4573
128,4,32,1,1,22,23,4365,78,4488
128,4,32,1,1,21,22,4365,216,4624
128,4,32,1,1,22,24,4367,95,4508
128,4,32,1,1,21,22,4364,76,4483
128,4,32,1,1,22,22,4373,202,4619
128,4,32,1,1,22,25,4369,124,4540
128,4,32,1,1,22,23,4366,121,4532
128,8,16,1,1,22,22,4401,188,4633
128,8,16,1,1,22,27,4397,81,4527
128,8,16,1,1,22,23,4396,101,4542
128,8,16,1,1,22,24,4399,166,4611
128,8,16,1,1,21,22,4395,79,4517
128,8,16,1,1,22,22,4396,107,4547
128,8,16,1,1,23,32,4410,145,4610
128,8,16,1,1,29,29,4405,219,4682
128,8,16,1,1,22,23,4397,84,4526
128,8,16,1,1,21,22,4395,89,4527
128,16,8,1,1,21,23,4458,101,4603
128,16,8,1,1,21,22,4457,77,4577
128,16,8,1,1,22,29,4464,125,4640
128,16,8,1,1,22,24,4458,81,4585
128,16,8,1,1,22,22,4456,75,4575
128,16,8,1,1,21,22,4461,214,4718
128,16,8,1,1,21,22,4457,89,4589
128,16,8,1,1,22,22,4462,287,4793
128,16,8,1,1,22,24,4460,119,4625
128,16,8,1,1,22,24,4458,80,4584
128,32,4,1,1,21,22,4587,151,4781
128,32,4,1,1,22,25,4591,122,4760
128,32,4,1,1,21,22,4587,79,4709
128,32,4,1,1,22,22,4587,174,4805
128,32,4,1,1,22,25,4594,119,4760
128,32,4,1,1,31,23,4587,74,4715
128,32,4,1,1,22,22,4590,141,4775
128,32,4,1,1,32,29,4590,117,4768
128,32,4,1,1,32,24,4586,75,4717
128,32,4,1,1,21,22,4592,232,4867
128,64,2,1,1,22,23,4626,157,4828
128,64,2,1,1,21,22,4603,74,4720
128,64,2,1,1,21,22,4608,158,4809
128,64,2,1,1,21,23,4604,96,4744
128,64,2,1,1,22,22,4604,74,4722
128,64,2,1,1,22,26,4610,139,4797
128,64,2,1,1,22,25,4607,79,4733
128,64,2,1,1,21,22,4604,74,4721
128,64,2,1,1,22,23,4607,141,4793
128,64,2,1,1,32,24,4604,127,4787
128,128,1,1,1,21,22,4616,82,4741
128,128,1,1,1,23,36,4626,140,4825
128,128,1,1,1,21,22,4615,79,4737
128,128,1,1,1,21,22,4615,134,4792
128,128,1,1,1,21,23,4616,86,4746
128,128,1,1,1,21,22,4618,124,4785
128,128,1,1,1,22,26,4617,118,4783
128,128,1,1,1,22,23,4617,77,4739
128,128,1,1,1,22,23,4617,146,4808
128,128,1,1,1,22,23,4615,116,4776
128,1,256,1,1,21,22,4378,80,4501
128,1,256,1,1,24,30,4386,110,4550
128,1,256,1,1,22,24,4381,86,4513
128,1,256,1,1,22,22,4379,75,4498
128,1,256,1,1,21,22,4386,282,4711
128,1,256,1,1,21,26,4383,131,4561
128,1,256,1,1,28,35,4401,194,4658
128,1,256,1,1,32,26,4382,139,4579
128,1,256,1,1,30,29,4387,161,4607
128,1,256,1,1,22,22,4384,99,4527
128,2,128,1,1,22,26,4400,120,4568
128,2,128,1,1,32,24,4400,140,4596
128,2,128,1,1,22,24,4399,120,4565
128,2,128,1,1,22,22,4397,77,4518
128,2,128,1,1,22,22,4399,137,4580
128,2,128,1,1,21,25,4399,118,4563
128,2,128,1,1,21,22,4395,75,4513
128,2,128,1,1,29,29,4404,196,4658
128,2,128,1,1,32,24,4405,245,4706
128,2,128,1,1,38,29,4402,129,4598
128,4,64,1,1,22,23,4417,180,4642
128,4,64,1,1,22,25,4417,127,4591
128,4,64,1,1,21,22,4411,81,4535
128,4,64,1,1,21,22,4418,176,4637
128,4,64,1,1,32,25,4450,154,4661
128,4,64,1,1,22,24,4420,184,4650
128,4,64,1,1,22,22,4417,153,4614
128,4,64,1,1,22,22,4412,78,4534
128,4,64,1,1,22,22,4412,103,4559
128,4,64,1,1,32,23,4416,174,4645
128,8,32,1,1,22,23,4449,154,4648
128,8,32,1,1,22,23,4451,188,4684
128,8,32,1,1,27,23,4447,77,4574
128,8,32,1,1,27,25,4451,142,4645
128,8,32,1,1,21,23,4449,130,4623
128,8,32,1,1,22,23,4447,77,4569
128,8,32,1,1,21,23,4449,140,4633
128,8,32,1,1,22,24,4448,112,4606
128,8,32,1,1,21,22,4446,79,4568
128,8,32,1,1,22,24,4450,146,4642
128,16,16,1,1,22,25,4519,221,4787
128,16,16,1,1,22,23,4517,165,4727
128,16,16,1,1,22,22,4513,80,4637
128,16,16,1,1,22,23,4514,115,4674
128,16,16,1,1,21,23,4516,167,4727
128,16,16,1,1,32,24,4514,96,4666
128,16,16,1,1,33,26,4516,126,4701
128,16,16,1,1,22,22,4517,149,4710
128,16,16,1,1,22,25,4515,107,4669
128,16,16,1,1,22,22,4512,77,4633
128,32,8,1,1,22,23,4672,212,4929
128,32,8,1,1,22,22,4669,134,4847
128,32,8,1,1,22,31,4678,128,4859
128,32,8,1,1,22,22,4666,78,4788
128,32,8,1,1,21,22,4668,139,4850
128,32,8,1,1,21,25,4670,123,4839
128,32,8,1,1,22,22,4667,75,4786
128,32,8,1,1,22,22,4671,197,4912
128,32,8,1,1,21,23,4668,84,4796
128,32,8,1,1,21,22,4667,85,4795
128,64,4,1,1,22,46,4683,92,4843
128,64,4,1,1,22,26,4667,129,4844
128,64,4,1,1,24,24,4665,80,4793
128,64,4,1,1,22,24,4665,85,4796
128,64,4,1,1,22,22,4665,132,4841
128,64,4,1,1,22,26,4665,115,4828
128,64,4,1,1,22,23,4666,81,4792
128,64,4,1,1,21,22,4673,292,5008
128,64,4,1,1,21,24,4668,99,4812
128,64,4,1,1,22,22,4663,75,4782
128,128,2,1,1,21,22,4667,138,4848
128,128,2,1,1,21,23,4666,78,4788
128,128,2,1,1,22,22,4667,191,4902
128,128,2,1,1,22,24,4668,85,4799
128,128,2,1,1,22,22,4663,78,4785
128,128,2,1,1,21,79,4682,159,4941
128,128,2,1,1,22,24,4665,94,4805
128,128,2,1,1,22,22,4663,88,4795
128,128,2,1,1,40,26,4667,141,4874
128,128,2,1,1,22,23,4663,83,4791
128,256,1,1,1,21,22,4617,92,4752
128,256,1,1,1,25,31,4615,86,4757
128,256,1,1,1,22,32,4619,78,4751
128,256,1,1,1,22,23,4620,163,4828
128,256,1,1,1,21,22,4617,78,4738
128,256,1,1,1,22,22,4621,206,4871
128,256,1,1,1,39,29,4621,104,4793
128,256,1,1,1,22,22,4612,79,4735
128,256,1,1,1,32,27,4620,123,4802
128,256,1,1,1,21,22,4616,74,4733
256,1,32,2,4,43,22,8998,129,9192
256,1,32,2,4,42,22,8997,164,9225
256,1,32,2,4,44,23,8993,80,9140
256,1,32,2,4,44,28,9001,123,9196
256,1,32,2,4,43,23,9003,216,9285
256,1,32,2,4,42,23,8996,79,9140
256,1,32,2,4,44,23,9000,130,9197
256,1,32,2,4,60,23,8996,155,9234
256,1,32,2,4,42,23,8996,104,9165
256,1,32,2,4,44,25,9001,126,9196
256,2,16,2,4,42,23,9002,135,9202
256,2,16,2,4,42,23,9000,97,9162
256,2,16,2,4,43,25,9003,124,9195
256,2,16,2,4,89,35,9009,146,9279
256,2,16,2,4,47,24,9004,238,9313
256,2,16,2,4,44,24,8999,80,9147
256,2,16,2,4,42,23,9001,125,9191
256,2,16,2,4,64,24,9003,181,9272
256,2,16,2,4,44,25,9001,85,9155
256,2,16,2,4,42,23,9004,125,9194
256,4,8,2,4,42,23,10597,155,10817
256,4,8,2,4,43,25,10604,150,10822
256,4,8,2,4,66,35,9002,131,9234
256,4,8,2,4,43,23,10597,169,10832
256,4,8,2,4,45,24,10592,145,10806
256,4,8,2,4,67,30,10634,167,10898
256,4,8,2,4,57,31,10587,123,10798
256,4,8,2,4,42,22,10585,128,10777
256,4,8,2,4,42,22,8989,79,9132
256,4,8,2,4,62,25,10589,137,10813
256,8,4,2,4,42,24,8993,84,9143
256,8,4,2,4,47,29,8998,125,9199
256,8,4,2,4,42,22,9017,285,9366
256,8,4,2,4,42,24,10557,90,10713
256,8,4,2,4,43,24,10568,125,10760
256,8,4,2,4,42,23,10561,133,10759
256,8,4,2,4,43,23,10561,141,10768
256,8,4,2,4,42,23,10569,85,10719
256,8,4,2,4,42,26,10571,124,10763
256,8,4,2,4,44,34,10568,113,10759
256,16,2,2,4,89,22,10445,125,10681
256,16,2,2,4,42,23,11318,142,11525
256,16,2,2,4,43,24,10442,162,10671
256,16,2,2,4,43,24,11315,86,11468
256,16,2,2,4,42,24,11316,122,11504
256,16,2,2,4,42,23,10440,175,10680
256,16,2,2,4,42,23,11319,142,11526
256,16,2,2,4,64,24,11314,142,11544
256,16,2,2,4,42,23,11323,147,11535
256,16,2,2,4,49,54,11334,208,11645
256,32,1,2,4,44,24,8997,120,9185
256,32,1,2,4,43,23,8999,145,9210
256,32,1,2,4,42,23,8996,90,9151
256,32,1,2,4,42,22,9000,129,9193
256,32,1,2,4,52,22,8995,247,9316
256,32,1,2,4,44,26,8996,123,9189
256,32,1,2,4,42,22,8997,128,9189
256,32,1,2,4,43,23,10928,210,11204
256,32,1,2,4,43,25,10913,115,11096
256,32,1,2,4,44,38,10917,126,11125
256,1,64,2,2,42,23,8978,142,9185
256,1,64,2,2,42,23,8952,82,9099
256,1,64,2,2,45,34,8957,126,9162
256,1,64,2,2,42,23,8954,129,9148
256,1,64,2,2,43,23,8940,94,9100
256,1,64,2,2,43,29,8948,120,9140
256,1,64,2,2,43,22,8955,154,9174
256,1,64,2,2,43,23,8942,109,9117
256,1,64,2,2,52,47,8970,127,9196
256,1,64,2,2,42,22,8942,141,9147
256,2,32,2,2,43,23,8944,137,9147
256,2,32,2,2,44,23,8956,137,9160
256,2,32,2,2,64,25,8961,83,9133
256,2,32,2,2,42,23,8954,183,9202
256,2,32,2,2,43,26,8953,87,9109
256,2,32,2,2,42,22,8957,126,9147
256,2,32,2,2,42,22,8957,78,9099
256,2,32,2,2,42,23,8959,127,9151
256,2,32,2,2,43,23,8957,149,9172
256,2,32,2,2,49,30,8959,197,9235
256,4,16,2,2,65,28,8973,167,9233
256,4,16,2,2,46,25,8980,141,9192
256,4,16,2,2,44,23,8962,138,9167
256,4,16,2,2,42,25,8965,81,9113
256,4,16,2,2,42,23,8965,119,9149
256,4,16,2,2,42,23,8961,130,9156
256,4,16,2,2,56,24,12004,127,12211
256,4,16,2,2,42,23,8961,129,9155
256,4,16,2,2,44,23,8967,174,9208
256,4,16,2,2,43,68,8985,127,9223
256,8,8,2,2,42,22,8975,176,9215
256,8,8,2,2,43,23,8967,88,9121
256,8,8,2,2,42,22,9062,123,9249
256,8,8,2,2,44,28,8989,192,9253
256,8,8,2,2,42,22,8976,161,9201
256,8,8,2,2,42,22,8978,236,9278
256,8,8,2,2,44,47,8988,126,9205
256,8,8,2,2,42,22,8979,147,9190
256,8,8,2,2,42,25,8975,101,9143
256,8,8,2,2,42,22,8967,127,9158
256,16,4,2,2,42,23,8986,96,9147
256,16,4,2,2,65,42,8962,130,9199
256,16,4,2,2,42,22,8971,143,9178
256,16,4,2,2,42,22,8965,80,9109
256,16,4,2,2,43,23,8967,133,9166
256,16,4,2,2,72,29,8975,170,9246
256,16,4,2,2,43,25,8976,152,9196
256,16,4,2,2,42,22,8966,147,9177
256,16,4,2,2,42,23,8970,87,9122
256,16,4,2,2,42,23,8974,132,9171
256,32,2,2,2,43,23,9052,166,9284
256,32,2,2,2,44,26,9051,131,9252
256,32,2,2,2,43,23,9054,272,9392
256,32,2,2,2,98,24,9038,87,9247
256,32,2,2,2,42,22,9044,127,9235
256,32,2,2,2,42,22,9042,98,9204
256,32,2,2,2,42,23,9051,85,9201
256,32,2,2,2,42,22,9045,129,9238
256,32,2,2,2,58,33,9056,131,9278
256,32,2,2,2,43,23,9052,151,9269
256,64,1,2,2,43,23,8985,233,9284
256,64,1,2,2,74,35,8973,122,9204
256,64,1,2,2,44,26,8990,130,9190
256,64,1,2,2,44,25,8989,151,9209
256,64,1,2,2,43,23,8976,152,9194
256,64,1,2,2,44,25,8985,90,9144
256,64,1,2,2,42,22,8981,184,9229
256,64,1,2,2,43,23,8980,86,9132
256,64,1,2,2,43,23,8975,125,9166
256,64,1,2,2,58,23,8969,78,9128
256,1,128,2,1,42,24,8855,125,9046
256,1,128,2,1,42,22,8857,246,9167
256,1,128,2,1,43,24,8855,108,9030
256,1,128,2,1,45,26,8857,134,9062
256,1,128,2,1,47,25,8861,132,9065
256,1,128,2,1,43,23,8858,109,9033
256,1,128,2,1,65,66,8858,124,9113
256,1,128,2,1,42,22,8863,163,9090
256,1,128,2,1,43,25,8863,94,9025
256,1,128,2,1,42,23,8860,143,9068
256,2,64,2,1,42,24,8855,88,9009
256,2,64,2,1,43,23,8862,126,9054
256,2,64,2,1,61,25,8852,181,9119
256,2,64,2,1,47,29,8869,229,9174
256,2,64,2,1,43,23,8856,154,9076
256,2,64,2,1,44,24,8858,106,9032
256,2,64,2,1,56,32,8869,133,9090
256,2,64,2,1,43,23,8864,148,9078
256,2,64,2,1,50,43,8866,147,9106
256,2,64,2,1,43,23,8863,133,9062
256,4,32,2,1,55,25,8861,129,9070
256,4,32,2,1,42,22,8856,145,9065
256,4,32,2,1,42,23,12130,161,12356
256,4,32,2,1,65,23,8860,171,9119
256,4,32,2,1,49,27,8866,139,9081
256,4,32,2,1,44,35,8869,129,9077
256,4,32,2,1,42,22,8860,291,9215
256,4,32,2,1,43,23,12683,151,12900
256,4,32,2,1,44,25,8855,90,9014
256,4,32,2,1,42,23,8887,132,9084
256,8,16,2,1,42,23,12051,211,12327
256,8,16,2,1,42,24,8851,112,9029
256,8,16,2,1,43,22,8856,141,9062
256,8,16,2,1,44,24,11757,138,11963
256,8,16,2,1,42,26,8857,123,9048
256,8,16,2,1,42,22,8846,146,9056
256,8,16,2,1,43,25,8843,84,8995
256,8,16,2,1,59,42,11879,128,12108
256,8,16,2,1,43,23,8844,127,9037
256,8,16,2,1,42,24,8843,81,8990
256,16,8,2,1,43,23,8860,128,9054
256,16,8,2,1,42,22,12842,129,13035
256,16,8,2,1,42,22,10239,113,10416
256,16,8,2,1,43,25,9872,88,10028
256,16,8,2,1,43,23,10878,124,11068
256,16,8,2,1,42,22,8851,178,9093
256,16,8,2,1,43,24,8845,85,8997
256,16,8,2,1,42,23,8917,127,9109
256,16,8,2,1,42,22,8851,151,9066
256,16,8,2,1,57,26,8855,127,9065
256,32,4,2,1,47,24,8885,133,9089
256,32,4,2,1,43,23,8886,157,9109
256,32,4,2,1,44,24,8884,84,9036
256,32,4,2,1,43,23,8885,136,9087
256,32,4,2,1,43,23,8882,81,9029
256,32,4,2,1,42,23,8885,167,9117
256,32,4,2,1,42,22,8889,251,9204
256,32,4,2,1,43,23,8887,191,9144
256,32,4,2,1,65,25,8890,291,9271
256,32,4,2,1,50,25,8885,122,9082
256,64,2,2,1,45,39,8910,137,9131
256,64,2,2,1,44,23,10103,132,10302
256,64,2,2,1,43,23,10096,256,10418
256,64,2,2,1,58,31,10104,157,10350
256,64,2,2,1,43,23,10422,144,10632
256,64,2,2,1,43,23,10220,141,10427
256,64,2,2,1,44,25,10277,135,10481
256,64,2,2,1,44,23,10370,128,10565
256,64,2,2,1,43,23,8904,169,9139
256,64,2,2,1,46,24,10424,154,10648
256,128,1,2,1,44,25,8925,136,9130
256,128,1,2,1,44,23,8922,127,9116
256,128,1,2,1,59,23,8922,78,9082
256,128,1,2,1,42,22,8924,127,9115
256,128,1,2,1,42,25,8920,84,9071
256,128,1,2,1,42,22,8922,125,9111
256,128,1,2,1,42,25,8919,89,9075
256,128,1,2,1,42,22,8922,124,9110
256,128,1,2,1,43,23,8922,82,9070
256,128,1,2,1,42,23,8924,127,9116
256,1,256,1,1,42,22,8717,184,8965
256,1,256,1,1,43,23,8715,82,8863
256,1,256,1,1,42,22,8716,137,8917
256,1,256,1,1,42,23,8715,81,8861
256,1,256,1,1,42,22,8716,130,8910
256,1,256,1,1,42,23,8711,80,8856
256,1,256,1,1,48,38,8726,128,8940
256,1,256,1,1,42,23,8716,132,8913
256,1,256,1,1,42,22,8712,81,8857
256,1,256,1,1,43,22,8715,129,8909
256,2,128,1,1,43,22,8732,156,8953
256,2,128,1,1,42,22,8732,106,8902
256,2,128,1,1,43,26,8768,123,8960
256,2,128,1,1,42,23,8733,180,8978
256,2,128,1,1,42,24,8731,79,8876
256,2,128,1,1,43,23,8735,140,8941
256,2,128,1,1,42,22,8731,83,8878
256,2,128,1,1,43,23,8734,131,8931
256,2,128,1,1,43,23,8734,154,8954
256,2,128,1,1,67,36,8746,189,9038
256,4,64,1,1,42,25,8750,93,8910
256,4,64,1,1,42,22,8752,131,8947
256,4,64,1,1,43,23,8747,93,8906
256,4,64,1,1,44,27,8753,121,8945
256,4,64,1,1,43,22,8753,128,8946
256,4,64,1,1,43,25,8751,84,8903
256,4,64,1,1,42,23,8752,123,8940
256,4,64,1,1,43,23,8750,177,8993
256,4,64,1,1,52,49,8775,145,9021
256,4,64,1,1,43,23,8755,199,9020
256,8,32,1,1,43,23,8784,83,8933
256,8,32,1,1,43,23,8785,124,8975
256,8,32,1,1,42,23,8786,80,8931
256,8,32,1,1,42,22,8785,128,8977
256,8,32,1,1,42,22,8782,77,8923
256,8,32,1,1,43,24,8783,85,8935
256,8,32,1,1,44,22,8786,130,8982
256,8,32,1,1,42,22,8781,97,8942
256,8,32,1,1,42,23,8785,127,8977
256,8,32,1,1,42,23,8786,200,9051
256,16,16,1,1,42,24,8849,94,9009
256,16,16,1,1,47,26,8850,123,9046
256,16,16,1,1,55,24,8851,128,9058
256,16,16,1,1,43,23,8851,161,9078
256,16,16,1,1,43,26,8853,117,9039
256,16,16,1,1,42,23,8855,131,9051
256,16,16,1,1,42,25,8848,92,9007
256,16,16,1,1,42,22,8850,145,9059
256,16,16,1,1,43,23,8850,103,9019
256,16,16,1,1,44,26,8854,127,9051
256,32,8,1,1,43,23,9012,279,9357
256,32,8,1,1,43,25,9004,93,9165
256,32,8,1,1,42,22,9007,152,9223
256,32,8,1,1,42,24,9005,82,9153
256,32,8,1,1,42,22,9005,135,9204
256,32,8,1,1,71,27,9006,110,9214
256,32,8,1,1,42,22,9006,142,9212
256,32,8,1,1,75,32,9007,123,9237
256,32,8,1,1,42,22,9003,132,9199
256,32,8,1,1,44,23,9001,85,9153
256,64,4,1,1,44,23,9006,125,9198
256,64,4,1,1,42,22,9003,100,9167
256,64,4,1,1,43,23,9002,91,9159
256,64,4,1,1,42,23,9004,145,9214
256,64,4,1,1,62,25,9003,87,9177
256,64,4,1,1,43,23,9002,79,9147
256,64,4,1,1,56,23,9003,119,9201
256,64,4,1,1,42,24,9003,89,9158
256,64,4,1,1,42,22,9010,127,9201
256,64,4,1,1,42,23,9002,80,9147
256,128,2,1,1,42,23,9008,127,9200
256,128,2,1,1,42,24,9005,83,9154
256,128,2,1,1,42,22,9008,127,9199
256,128,2,1,1,42,23,9004,121,9190
256,128,2,1,1,42,23,9008,129,9202
256,128,2,1,1,42,23,9003,76,9144
256,128,2,1,1,42,22,9007,126,9197
256,128,2,1,1,42,23,9005,114,9184
256,128,2,1,1,53,23,9007,132,9215
256,128,2,1,1,42,22,9014,410,9488
256,256,1,1,1,43,24,9022,129,9218
256,256,1,1,1,42,23,9022,142,9229
256,256,1,1,1,43,26,9022,132,9223
256,256,1,1,1,42,23,9021,142,9228
256,256,1,1,1,43,32,9029,120,9224
256,256,1,1,1,43,23,9022,153,9241
256,256,1,1,1,60,25,9019,117,9221
256,256,1,1,1,43,22,9020,228,9313
256,256,1,1,1,44,24,9026,124,9218
256,256,1,1,1,43,22,9021,131,9217
512,1,32,4,4,85,24,25764,127,26000
512,1,32,4,4,97,24,25755,129,26005
512,1,32,4,4,85,22,25766,193,26066
512,1,32,4,4,86,39,25742,131,25998
512,1,32,4,4,84,22,25740,139,25985
512,1,32,4,4,86,39,25756,129,26010
512,1,32,4,4,96,23,25742,184,26045
512,1,32,4,4,85,23,25761,122,25991
512,1,32,4,4,84,23,25756,138,26001
512,1,32,4,4,84,24,25744,126,25978
512,2,16,4,4,87,27,24895,126,25135
512,2,16,4,4,146,37,24839,192,25214
512,2,16,4,4,85,25,25302,131,25543
512,2,16,4,4,85,22,25317,135,25559
512,2,16,4,4,85,23,25313,124,25545
512,2,16,4,4,87,25,24893,145,25150
512,2,16,4,4,85,24,25308,148,25565
512,2,16,4,4,85,28,25305,125,25543
512,2,16,4,4,84,24,24684,143,24935
512,2,16,4,4,85,26,24835,127,25073
512,4,8,4,4,84,24,24539,146,24793
512,4,8,4,4,87,25,23529,139,23780
512,4,8,4,4,84,23,23550,326,23983
512,4,8,4,4,85,24,23580,140,23829
512,4,8,4,4,84,24,23528,135,23771
512,4,8,4,4,85,23,24538,139,24785
512,4,8,4,4,88,25,23582,121,23816
512,4,8,4,4,87,24,24743,134,24988
512,4,8,4,4,85,29,23588,133,23835
512,4,8,4,4,85,23,24537,135,24780
512,8,4,4,4,85,23,23959,128,24195
512,8,4,4,4,87,23,24434,211,24755
512,8,4,4,4,93,26,27090,131,27340
512,8,4,4,4,84,23,23970,141,24218
512,8,4,4,4,85,25,25888,140,26138
512,8,4,4,4,87,24,25831,166,26108
512,8,4,4,4,84,24,24429,137,24674
512,8,4,4,4,84,31,24722,127,24964
512,8,4,4,4,87,23,24430,129,24669
512,8,4,4,4,84,23,26428,132,26667
512,16,2,4,4,85,24,24985,146,25240
512,16,2,4,4,87,27,25801,129,26044
512,16,2,4,4,84,24,27076,140,27324
512,16,2,4,4,127,26,26792,127,27072
512,16,2,4,4,84,23,26443,125,26675
512,16,2,4,4,85,24,25774,130,26013
512,16,2,4,4,84,24,25760,123,25991
512,16,2,4,4,87,24,25790,132,26033
512,16,2,4,4,127,27,25792,132,26078
512,16,2,4,4,85,23,26922,144,27174
512,32,1,4,4,85,23,25970,131,26209
512,32,1,4,4,85,23,28050,164,28322
512,32,1,4,4,84,24,25942,144,26194
512,32,1,4,4,87,25,28051,139,28302
512,32,1,4,4,84,24,28059,135,28302
512,32,1,4,4,84,24,25936,140,26184
512,32,1,4,4,87,24,28048,136,28295
512,32,1,4,4,84,24,25039,128,25275
512,32,1,4,4,85,23,25903,127,26138
512,32,1,4,4,85,29,25904,133,26151
512,1,64,2,4,85,23,17705,126,17939
512,1,64,2,4,84,24,17702,128,17938
512,1,64,2,4,85,24,17714,130,17953
512,1,64,2,4,84,24,17732,120,17960
512,1,64,2,4,84,23,20291,149,20547
512,1,64,2,4,120,26,17724,148,18018
512,1,64,2,4,94,32,17724,188,18038
512,1,64,2,4,85,25,17741,159,18010
512,1,64,2,4,84,24,17686,135,17929
512,1,64,2,4,85,24,17689,134,17932
512,2,32,2,4,87,24,17735,131,17977
512,2,32,2,4,85,22,17707,166,17980
512,2,32,2,4,86,23,17712,132,17953
512,2,32,2,4,84,24,17707,130,17945
512,2,32,2,4,87,22,17725,122,17956
512,2,32,2,4,85,23,17720,128,17956
512,2,32,2,4,84,23,17722,130,17959
512,2,32,2,4,85,23,17726,156,17990
512,2,32,2,4,84,24,17708,145,17961
512,2,32,2,4,87,23,17723,129,17962
512,4,16,2,4,84,24,17744,125,17977
512,4,16,2,4,84,24,17748,134,17990
512,4,16,2,4,84,24,17741,129,17978
512,4,16,2,4,86,24,17765,144,18019
512,4,16,2,4,84,23,23575,210,23892
512,4,16,2,4,128,24,17749,131,18032
512,4,16,2,4,84,27,17756,166,18033
512,4,16,2,4,114,33,17749,150,18046
512,4,16,2,4,127,24,17748,128,18027
512,4,16,2,4,85,25,17729,126,17965
512,8,8,2,4,125,24,17766,131,18046
512,8,8,2,4,84,23,25286,128,25521
512,8,8,2,4,162,74,23619,139,23994
512,8,8,2,4,87,24,23112,129,23352
512,8,8,2,4,85,23,17757,130,17995
512,8,8,2,4,84,23,22900,147,23154
512,8,8,2,4,103,26,23555,131,23815
512,8,8,2,4,87,24,23538,151,23800
512,8,8,2,4,95,26,23541,129,23791
512,8,8,2,4,85,23,23592,192,23892
512,16,4,2,4,85,25,20066,140,20316
512,16,4,2,4,85,24,24922,120,25151
512,16,4,2,4,84,24,25447,132,25687
512,16,4,2,4,84,25,25512,132,25753
512,16,4,2,4,85,23,25375,146,25629
512,16,4,2,4,85,25,20567,137,20814
512,16,4,2,4,104,24,23762,224,24114
512,16,4,2,4,96,27,20560,139,20822
512,16,4,2,4,85,26,25379,145,25635
512,16,4,2,4,84,22,20439,137,20682
512,32,2,2,4,85,25,23331,130,23571
512,32,2,2,4,84,23,23375,136,23618
512,32,2,2,4,87,24,23354,134,23599
512,32,2,2,4,85,25,23658,180,23948
512,32,2,2,4,87,25,23296,254,23662
512,32,2,2,4,103,26,23289,142,23560
512,32,2,2,4,123,30,23366,142,23661
512,32,2,2,4,87,25,23349,154,23615
512,32,2,2,4,87,24,23269,133,23513
512,32,2,2,4,87,23,24083,133,24326
512,64,1,2,4,87,24,23541,136,23788
512,64,1,2,4,87,24,23568,140,23819
512,64,1,2,4,87,25,23565,137,23814
512,64,1,2,4,107,26,17786,158,18077
512,64,1,2,4,127,26,23379,136,23668
512,64,1,2,4,109,31,23564,134,23838
512,64,1,2,4,105,35,22930,130,23200
512,64,1,2,4,107,24,23555,121,23807
512,64,1,2,4,84,22,23189,133,23428
512,64,1,2,4,85,24,23212,131,23452
512,1,128,2,2,84,23,17493,127,17727
512,1,128,2,2,85,23,17497,135,17740
512,1,128,2,2,85,24,17492,130,17731
512,1,128,2,2,84,24,17484,147,17739
512,1,128,2,2,85,24,17482,130,17721
512,1,128,2,2,85,25,17481,143,17734
512,1,128,2,2,85,24,17487,129,17725
512,1,128,2,2,84,24,17488,132,17728
512,1,128,2,2,85,24,17484,168,17761
512,1,128,2,2,84,24,17483,128,17719
512,2,64,2,2,85,24,17476,125,17710
512,2,64,2,2,84,24,17459,128,17695
512,2,64,2,2,84,23,17471,129,17707
512,2,64,2,2,85,23,17472,121,17701
512,2,64,2,2,87,23,17479,137,17726
512,2,64,2,2,85,30,17492,140,17747
512,2,64,2,2,85,26,17490,136,17737
512,2,64,2,2,85,28,17488,152,17753
512,2,64,2,2,85,25,17472,144,17726
512,2,64,2,2,85,25,17483,127,17720
512,4,32,2,2,84,23,17497,132,17736
512,4,32,2,2,87,22,17487,126,17722
512,4,32,2,2,87,23,17485,124,17719
512,4,32,2,2,84,32,20922,136,21174
512,4,32,2,2,85,23,17482,125,17715
512,4,32,2,2,84,23,17492,134,17733
512,4,32,2,2,84,24,17461,130,17699
512,4,32,2,2,139,37,17458,126,17760
512,4,32,2,2,84,23,17476,124,17707
512,4,32,2,2,124,24,17473,121,17742
512,8,16,2,2,85,24,17478,159,17746
512,8,16,2,2,128,67,24423,129,24747
512,8,16,2,2,89,26,17484,129,17728
512,8,16,2,2,88,25,22696,165,22974
512,8,16,2,2,125,61,23198,127,23511
512,8,16,2,2,84,24,20073,129,20310
512,8,16,2,2,84,23,19979,160,20246
512,8,16,2,2,85,33,18161,179,18458
512,8,16,2,2,85,26,22757,130,22998
512,8,16,2,2,85,23,17480,133,17721
512,16,8,2,2,87,24,17489,131,17731
512,16,8,2,2,84,24,17492,129,17729
512,16,8,2,2,87,25,17490,124,17726
512,16,8,2,2,84,24,17488,133,17729
512,16,8,2,2,96,23,17498,136,17753
512,16,8,2,2,85,26,17493,158,17762
512,16,8,2,2,85,23,17491,144,17743
512,16,8,2,2,84,24,17493,133,17734
512,16,8,2,2,87,24,17489,127,17727
512,16,8,2,2,107,36,17495,150,17788
512,32,4,2,2,85,26,17616,134,17861
512,32,4,2,2,85,25,17616,126,17852
512,32,4,2,2,87,24,17617,134,17862
512,32,4,2,2,133,29,17619,140,17921
512,32,4,2,2,85,23,17614,136,17858
512,32,4,2,2,85,27,17620,143,17875
512,32,4,2,2,87,24,17618,133,17862
512,32,4,2,2,87,24,17620,133,17864
512,32,4,2,2,87,25,17618,208,17938
512,32,4,2,2,85,27,17619,196,17927
512,64,2,2,2,87,25,17641,143,17896
512,64,2,2,2,85,25,17639,127,17876
512,64,2,2,2,84,23,17635,128,17870
512,64,2,2,2,133,24,17637,138,17932
512,64,2,2,2,87,24,17638,130,17879
512,64,2,2,2,84,24,17635,128,17871
512,64,2,2,2,95,26,17637,172,17930
512,64,2,2,2,85,25,17637,136,17883
512,64,2,2,2,85,24,17637,127,17873
512,64,2,2,2,87,24,17638,129,17878
512,128,1,2,2,84,22,17638,130,17874
512,128,1,2,2,87,24,17636,126,17873
512,128,1,2,2,87,24,17637,137,17885
512,128,1,2,2,87,24,17635,132,17878
512,128,1,2,2,84,75,17636,149,17944
512,128,1,2,2,84,24,17635,129,17872
512,128,1,2,2,84,24,17640,128,17876
512,128,1,2,2,110,28,17640,165,17943
512,128,1,2,2,85,25,17640,155,17905
512,128,1,2,2,90,25,17642,141,17898
512,1,256,2,1,85,23,17556,126,17790
512,1,256,2,1,87,23,17567,131,17808
512,1,256,2,1,85,23,17561,126,17795
512,1,256,2,1,84,24,20581,133,20822
512,1,256,2,1,88,35,17564,137,17824
512,1,256,2,1,127,28,17568,137,17860
512,1,256,2,1,85,25,17567,142,17819
512,1,256,2,1,84,24,17562,126,17796
512,1,256,2,1,87,24,17568,131,17810
512,1,256,2,1,84,23,17569,123,17799
512,2,128,2,1,85,23,17556,130,17794
512,2,128,2,1,87,24,17549,128,17788
512,2,128,2,1,84,23,17561,121,17789
512,2,128,2,1,87,23,17549,128,17787
512,2,128,2,1,87,23,17550,150,17810
512,2,128,2,1,85,26,17552,219,17882
512,2,128,2,1,187,27,17560,130,17904
512,2,128,2,1,85,24,17569,138,17816
512,2,128,2,1,97,27,17566,128,17818
512,2,128,2,1,85,24,17551,130,17790
512,4,64,2,1,87,24,17546,134,17791
512,4,64,2,1,126,53,17548,167,17894
512,4,64,2,1,87,27,17560,140,17814
512,4,64,2,1,85,25,17547,136,17793
512,4,64,2,1,84,24,17561,131,17800
512,4,64,2,1,84,24,19409,126,19643
512,4,64,2,1,84,24,17556,154,17818
512,4,64,2,1,85,24,21179,136,21424
512,4,64,2,1,85,25,17555,126,17791
512,4,64,2,1,85,23,17541,126,17775
512,8,32,2,1,101,28,20429,138,20696
512,8,32,2,1,84,23,17544,128,17779
512,8,32,2,1,84,24,20690,154,20952
512,8,32,2,1,84,25,23415,130,23654
512,8,32,2,1,84,24,20738,127,20973
512,8,32,2,1,84,23,23019,149,23275
512,8,32,2,1,85,27,17548,134,17794
512,8,32,2,1,85,25,23037,130,23277
512,8,32,2,1,87,24,23065,178,23354
512,8,32,2,1,89,24,24952,143,25208
512,16,16,2,1,85,24,23042,145,23296
512,16,16,2,1,89,28,17554,147,17818
512,16,16,2,1,90,25,22982,126,23223
512,16,16,2,1,84,24,23154,154,23416
512,16,16,2,1,85,26,17560,204,17875
512,16,16,2,1,103,43,17568,200,17914
512,16,16,2,1,85,24,23150,127,23386
512,16,16,2,1,87,24,17545,125,17781
512,16,16,2,1,85,25,17546,125,17781
512,16,16,2,1,87,24,17550,131,17792
512,32,8,2,1,84,24,17650,128,17886
512,32,8,2,1,86,23,17648,139,17896
512,32,8,2,1,85,24,17652,135,17896
512,32,8,2,1,84,24,17651,138,17897
512,32,8,2,1,85,24,17648,129,17886
512,32,8,2,1,85,23,17648,132,17888
512,32,8,2,1,87,24,17649,129,17889
512,32,8,2,1,84,24,17648,130,17886
512,32,8,2,1,84,24,17652,163,17923
512,32,8,2,1,85,24,17650,134,17893
512,64,4,2,1,84,24,17651,144,17903
512,64,4,2,1,88,41,17664,151,17944
512,64,4,2,1,127,32,17652,162,17973
512,64,4,2,1,85,25,17653,198,17961
512,64,4,2,1,85,50,17655,172,17962
512,64,4,2,1,86,26,17656,166,17934
512,64,4,2,1,85,25,17651,141,17902
512,64,4,2,1,85,25,17652,153,17915
512,64,4,2,1,85,25,17648,159,17917
512,64,4,2,1,125,45,17651,152,17973
512,128,2,2,1,141,27,17655,141,17964
512,128,2,2,1,84,25,17658,146,17913
512,128,2,2,1,128,26,17654,137,17945
512,128,2,2,1,85,23,17652,139,17899
512,128,2,2,1,85,26,17651,151,17913
512,128,2,2,1,86,27,17655,155,17923
512,128,2,2,1,122,29,17659,144,17954
512,128,2,2,1,85,27,17655,139,17906
512,128,2,2,1,138,25,17657,205,18025
512,128,2,2,1,87,24,17651,128,17890
512,256,1,2,1,127,38,17718,133,18016
512,256,1,2,1,84,24,17672,132,17912
512,256,1,2,1,85,24,17675,135,17919
512,256,1,2,1,84,24,17678,127,17913
512,256,1,2,1,87,24,17678,133,17922
512,256,1,2,1,84,24,17676,145,17929
512,256,1,2,1,84,23,17679,126,17912
512,256,1,2,1,84,24,17674,126,17908
512,256,1,2,1,84,22,17675,127,17908
512,256,1,2,1,84,24,17677,129,17914
1024,1,32,4,8,195,26,53124,133,53478
1024,1,32,4,8,224,38,52606,167,53035
1024,1,32,4,8,291,27,52597,154,53069
1024,1,32,4,8,207,27,47791,152,48177
1024,1,32,4,8,170,28,38547,133,38878
1024,1,32,4,8,241,26,42164,374,42805
1024,1,32,4,8,174,31,41744,135,42084
1024,1,32,4,8,169,25,41841,134,42169
1024,1,32,4,8,223,26,42265,127,42641
1024,1,32,4,8,286,39,39012,134,39471
1024,2,16,4,8,173,26,40800,127,41126
1024,2,16,4,8,169,25,39446,207,39847
1024,2,16,4,8,274,45,39267,126,39712
1024,2,16,4,8,169,26,40792,275,41262
1024,2,16,4,8,287,36,39506,134,39963
1024,2,16,4,8,169,25,39506,132,39832
1024,2,16,4,8,169,25,40596,148,40938
1024,2,16,4,8,169,27,40807,175,41178
1024,2,16,4,8,169,25,40567,147,40908
1024,2,16,4,8,172,27,38833,204,39236
1024,4,8,4,8,169,25,40649,134,40977
1024,4,8,4,8,169,25,38944,145,39283
1024,4,8,4,8,173,27,38365,138,38703
1024,4,8,4,8,169,26,39269,181,39645
1024,4,8,4,8,261,32,40705,187,41185
1024,4,8,4,8,169,25,40687,202,41083
1024,4,8,4,8,170,28,39720,135,40053
1024,4,8,4,8,169,26,41746,141,42082
1024,4,8,4,8,170,29,38908,129,39236
1024,4,8,4,8,169,25,38913,143,39250
1024,8,4,4,8,169,25,40292,145,40631
1024,8,4,4,8,251,31,39656,127,40065
1024,8,4,4,8,169,25,39654,141,39989
1024,8,4,4,8,169,25,39643,145,39982
1024,8,4,4,8,191,28,39989,130,40338
1024,8,4,4,8,169,25,39638,139,39971
1024,8,4,4,8,212,26,39652,134,40024
1024,8,4,4,8,169,25,39664,135,39993
1024,8,4,4,8,254,26,39664,194,40138
1024,8,4,4,8,173,30,39655,144,40002
1024,16,2,4,8,169,25,40129,136,40459
1024,16,2,4,8,169,27,40148,133,40477
1024,16,2,4,8,169,25,39874,129,40197
1024,16,2,4,8,169,25,40143,261,40598
1024,16,2,4,8,178,31,38530,148,38887
1024,16,2,4,8,208,27,40169,136,40540
1024,16,2,4,8,169,25,39969,162,40325
1024,16,2,4,8,169,26,39969,133,40297
1024,16,2,4,8,169,26,40200,235,40630
1024,16,2,4,8,169,26,39959,135,40289
1024,32,1,4,8,219,26,38178,139,38562
1024,32,1,4,8,169,26,38098,151,38444
1024,32,1,4,8,169,26,39374,147,39716
1024,32,1,4,8,169,25,37928,131,38253
1024,32,1,4,8,254,35,37770,150,38209
1024,32,1,4,8,169,25,39317,130,39641
1024,32,1,4,8,169,26,39051,158,39404
1024,32,1,4,8,169,28,38045,132,38374
1024,32,1,4,8,169,26,39141,132,39468
1024,32,1,4,8,169,25,40103,150,40447
1024,1,64,4,4,169,27,37086,138,37420
1024,1,64,4,4,169,25,42003,154,42351
1024,1,64,4,4,169,25,37422,150,37766
1024,1,64,4,4,186,45,36889,141,37261
1024,1,64,4,4,173,26,37159,149,37507
1024,1,64,4,4,169,27,37076,125,37397
1024,1,64,4,4,169,26,36655,129,36979
1024,1,64,4,4,179,26,36437,134,36776
1024,1,64,4,4,169,26,36904,217,37316
1024,1,64,4,4,242,29,36340,141,36752
1024,2,32,4,4,169,26,35003,134,35332
1024,2,32,4,4,173,26,38945,136,39280
1024,2,32,4,4,173,26,35304,131,35634
1024,2,32,4,4,169,26,35171,245,35611
1024,2,32,4,4,169,25,35311,160,35665
1024,2,32,4,4,293,93,35916,138,36440
1024,2,32,4,4,249,30,35308,147,35734
1024,2,32,4,4,256,27,35649,167,36099
1024,2,32,4,4,169,25,35306,125,35625
1024,2,32,4,4,169,26,35146,133,35474
1024,4,16,4,4,169,42,38303,219,38733
1024,4,16,4,4,215,41,38560,132,38948
1024,4,16,4,4,169,27,37751,137,38084
1024,4,16,4,4,172,26,37744,136,38078
1024,4,16,4,4,169,25,37631,134,37959
1024,4,16,4,4,209,27,40391,133,40760
1024,4,16,4,4,217,26,37639,125,38007
1024,4,16,4,4,174,34,37636,133,37977
1024,4,16,4,4,184,26,35989,128,36327
1024,4,16,4,4,173,26,38512,288,38999
1024,8,8,4,4,169,27,37766,143,38105
1024,8,8,4,4,169,25,38240,146,38580
1024,8,8,4,4,190,29,39657,140,40016
1024,8,8,4,4,169,26,36779,130,37104
1024,8,8,4,4,173,26,37720,139,38058
1024,8,8,4,4,169,28,36030,147,36374
1024,8,8,4,4,169,27,36018,129,36343
1024,8,8,4,4,260,27,35468,134,35889
1024,8,8,4,4,248,26,35313,130,35717
1024,8,8,4,4,169,26,35558,130,35883
1024,16,4,4,4,173,26,37565,158,37922
1024,16,4,4,4,179,31,38482,130,38822
1024,16,4,4,4,169,26,37094,129,37418
1024,16,4,4,4,169,25,36650,131,36975
1024,16,4,4,4,169,26,37155,175,37525
1024,16,4,4,4,219,32,36158,132,36541
1024,16,4,4,4,169,25,37538,137,37869
1024,16,4,4,4,169,26,37507,129,37831
1024,16,4,4,4,169,26,35272,135,35602
1024,16,4,4,4,215,26,38393,151,38785
1024,32,2,4,4,169,28,34502,134,34833
1024,32,2,4,4,169,25,36791,128,37113
1024,32,2,4,4,169,25,34426,131,34751
1024,32,2,4,4,169,25,39316,169,39679
1024,32,2,4,4,174,33,34771,140,35118
1024,32,2,4,4,169,25,38690,161,39045
1024,32,2,4,4,169,28,34687,164,35048
1024,32,2,4,4,169,26,39610,132,39937
1024,32,2,4,4,169,26,41686,179,42060
1024,32,2,4,4,252,35,39388,133,39808
1024,64,1,4,4,172,26,39188,222,39608
1024,64,1,4,4,196,41,39193,137,39567
1024,64,1,4,4,173,27,40417,137,40754
1024,64,1,4,4,169,26,34313,136,34644
1024,64,1,4,4,169,26,35178,151,35524
1024,64,1,4,4,253,27,39181,130,39591
1024,64,1,4,4,169,25,35178,131,35503
1024,64,1,4,4,169,25,39182,171,39547
1024,64,1,4,4,169,32,33988,163,34352
1024,64,1,4,4,174,27,39180,206,39587
1024,1,128,2,4,173,26,29933,128,30260
1024,1,128,2,4,169,25,29722,145,30061
1024,1,128,2,4,307,30,29930,175,30442
1024,1,128,2,4,288,44,31078,180,31590
1024,1,128,2,4,169,26,29493,129,29817
1024,1,128,2,4,185,26,30644,133,30988
1024,1,128,2,4,169,26,29588,144,29927
1024,1,128,2,4,169,26,29409,206,29810
1024,1,128,2,4,170,31,31095,129,31425
1024,1,128,2,4,169,26,26718,138,27051
1024,2,64,2,4,169,25,27284,332,27810
1024,2,64,2,4,169,29,29493,137,29828
1024,2,64,2,4,169,26,29827,132,30154
1024,2,64,2,4,169,25,28032,135,28361
1024,2,64,2,4,169,26,28771,141,29107
1024,2,64,2,4,169,27,26723,149,27068
1024,2,64,2,4,169,25,27155,129,27478
1024,2,64,2,4,169,27,26722,137,27055
1024,2,64,2,4,174,27,26721,137,27059
1024,2,64,2,4,175,42,29471,147,29835
1024,4,32,2,4,173,26,31024,134,31357
1024,4,32,2,4,254,26,28913,131,29324
1024,4,32,2,4,173,26,31979,133,32311
1024,4,32,2,4,173,26,30289,136,30624
1024,4,32,2,4,199,31,31392,241,31863
1024,4,32,2,4,169,28,31476,133,31806
1024,4,32,2,4,169,25,30687,124,31005
1024,4,32,2,4,169,25,27464,133,27791
1024,4,32,2,4,169,25,30788,136,31118
1024,4,32,2,4,176,25,30781,139,31121
1024,8,16,2,4,169,27,28438,129,28763
1024,8,16,2,4,169,25,31766,131,32091
1024,8,16,2,4,169,25,36189,136,36519
1024,8,16,2,4,244,33,31821,131,32229
1024,8,16,2,4,256,26,38226,136,38644
1024,8,16,2,4,169,26,30629,326,31150
1024,8,16,2,4,188,29,29855,131,30203
1024,8,16,2,4,169,26,36635,194,37024
1024,8,16,2,4,219,26,33093,149,33487
1024,8,16,2,4,256,30,37628,136,38050
1024,16,8,2,4,169,25,34188,131,34513
1024,16,8,2,4,169,26,35069,132,35396
1024,16,8,2,4,169,26,33615,131,33941
1024,16,8,2,4,191,43,34678,136,35048
1024,16,8,2,4,169,28,37890,132,38219
1024,16,8,2,4,217,38,38068,147,38470
1024,16,8,2,4,169,25,36024,129,36347
1024,16,8,2,4,169,25,31568,133,31895
1024,16,8,2,4,169,25,36225,129,36548
1024,16,8,2,4,173,25,30753,131,31082
1024,32,4,2,4,169,27,30383,134,30713
1024,32,4,2,4,169,27,30736,249,31181
1024,32,4,2,4,173,29,26716,142,27060
1024,32,4,2,4,178,27,30225,132,30562
1024,32,4,2,4,173,26,26714,134,27047
1024,32,4,2,4,254,29,33667,131,34081
1024,32,4,2,4,169,27,32686,132,33014
1024,32,4,2,4,169,25,26709,126,27029
1024,32,4,2,4,191,47,26718,131,27087
1024,32,4,2,4,169,26,31943,130,32268
1024,64,2,2,4,219,26,34513,157,34915
1024,64,2,2,4,181,28,33502,129,33840
1024,64,2,2,4,215,25,33748,135,34123
1024,64,2,2,4,169,26,32093,139,32427
1024,64,2,2,4,169,25,30107,131,30432
1024,64,2,2,4,172,32,32392,216,32812
1024,64,2,2,4,169,26,33045,137,33377
1024,64,2,2,4,294,30,34142,149,34615
1024,64,2,2,4,174,27,31080,135,31416
1024,64,2,2,4,169,27,31864,158,32218
1024,128,1,2,4,184,27,26714,132,27057
1024,128,1,2,4,169,26,26713,150,27058
1024,128,1,2,4,169,26,26712,139,27046
1024,128,1,2,4,169,25,26716,133,27043
1024,128,1,2,4,169,25,26716,216,27126
1024,128,1,2,4,169,26,26708,132,27035
1024,128,1,2,4,169,25,26714,147,27055
1024,128,1,2,4,211,32,26720,130,27093
1024,128,1,2,4,169,25,26723,159,27076
1024,128,1,2,4,173,27,26711,135,27046
1024,1,256,2,2,169,26,27472,132,27799
1024,1,256,2,2,169,26,28329,185,28709
1024,1,256,2,2,183,27,30437,138,30785
1024,1,256,2,2,173,26,26519,129,26847
1024,1,256,2,2,217,28,29649,171,30065
1024,1,256,2,2,170,39,26769,131,27109
1024,1,256,2,2,173,26,29988,132,30319
1024,1,256,2,2,169,26,26520,153,26868
1024,1,256,2,2,169,26,30318,241,30754
1024,1,256,2,2,196,37,34184,228,34645
1024,2,128,2,2,169,27,34572,146,34914
1024,2,128,2,2,254,31,33118,142,33545
1024,2,128,2,2,170,31,31084,3130,34415
1024,2,128,2,2,169,28,27527,157,27881
1024,2,128,2,2,169,26,30779,192,31166
1024,2,128,2,2,169,28,29828,242,30267
1024,2,128,2,2,170,26,28290,127,28613
1024,2,128,2,2,169,26,32622,131,32948
1024,2,128,2,2,169,25,27731,159,28084
1024,2,128,2,2,173,27,29209,159,29568
1024,4,64,2,2,169,25,33133,167,33494
1024,4,64,2,2,188,32,35458,136,35814
1024,4,64,2,2,170,28,31557,223,31978
1024,4,64,2,2,224,38,32612,161,33035
1024,4,64,2,2,189,34,32225,148,32596
1024,4,64,2,2,174,31,26791,134,27130
1024,4,64,2,2,169,26,26794,133,27122
1024,4,64,2,2,169,25,26788,129,27111
1024,4,64,2,2,169,26,26798,177,27170
1024,4,64,2,2,172,25,29831,133,30161
1024,8,32,2,2,169,28,39691,136,40024
1024,8,32,2,2,169,25,37330,181,37705
1024,8,32,2,2,173,29,29130,137,29469
1024,8,32,2,2,294,34,33480,183,33991
1024,8,32,2,2,169,27,37342,129,37667
1024,8,32,2,2,169,27,38646,128,38970
1024,8,32,2,2,169,25,32451,129,32774
1024,8,32,2,2,169,25,37943,129,38266
1024,8,32,2,2,187,66,38406,146,38805
1024,8,32,2,2,169,30,37214,131,37544
1024,16,16,2,2,178,26,34310,135,34649
1024,16,16,2,2,193,28,28290,131,28642
1024,16,16,2,2,169,26,35284,157,35636
1024,16,16,2,2,169,26,34040,168,34403
1024,16,16,2,2,173,27,33996,144,34340
1024,16,16,2,2,170,32,32092,138,32432
1024,16,16,2,2,169,26,32400,141,32736
1024,16,16,2,2,169,25,33962,131,34287
1024,16,16,2,2,169,26,33365,126,33686
1024,16,16,2,2,173,26,34095,135,34429
1024,32,8,2,2,254,27,26684,219,27184
1024,32,8,2,2,174,27,29533,137,29871
1024,32,8,2,2,169,26,28854,128,29177
1024,32,8,2,2,254,26,29123,165,29568
1024,32,8,2,2,249,27,26687,181,27144
1024,32,8,2,2,176,51,28857,139,29223
1024,32,8,2,2,173,26,26684,133,27016
1024,32,8,2,2,171,26,26686,131,27014
1024,32,8,2,2,232,26,31034,139,31431
1024,32,8,2,2,170,31,26686,129,27016
1024,64,4,2,2,169,26,26693,242,27130
1024,64,4,2,2,203,39,26700,131,27073
1024,64,4,2,2,169,26,29001,134,29330
1024,64,4,2,2,169,26,28645,162,29002
1024,64,4,2,2,230,34,28163,168,28595
1024,64,4,2,2,173,27,26699,132,27031
1024,64,4,2,2,204,27,26701,130,27062
1024,64,4,2,2,173,26,31444,155,31798
1024,64,4,2,2,173,26,28763,194,29156
1024,64,4,2,2,222,32,26710,172,27136
1024,128,2,2,2,198,50,26703,133,27084
1024,128,2,2,2,169,26,26692,147,27034
1024,128,2,2,2,169,29,26706,153,27057
1024,128,2,2,2,169,26,26694,128,27017
1024,128,2,2,2,169,26,28961,170,29326
1024,128,2,2,2,183,27,31635,141,31986
1024,128,2,2,2,188,27,26698,138,27051
1024,128,2,2,2,173,26,26700,164,27063
1024,128,2,2,2,169,32,26695,128,27024
1024,128,2,2,2,169,25,26696,130,27020
1024,256,1,2,2,173,26,26686,147,27032
1024,256,1,2,2,174,30,26685,132,27021
1024,256,1,2,2,169,25,26684,150,27028
1024,256,1,2,2,169,27,26685,183,27064
1024,256,1,2,2,181,37,26679,154,27051
1024,256,1,2,2,169,26,26688,130,27013
1024,256,1,2,2,173,25,26682,240,27120
1024,256,1,2,2,169,26,26683,128,27006
1024,256,1,2,2,169,26,26683,131,27009
1024,256,1,2,2,173,25,26682,240,27120
2048,1,32,8,8,338,32,80942,146,81458
2048,1,32,8,8,337,28,82119,140,82624
2048,1,32,8,8,346,29,81613,140,82128
2048,1,32,8,8,346,29,79675,140,80190
2048,1,32,8,8,338,29,80965,139,81471
2048,1,32,8,8,337,29,81158,155,81679
2048,1,32,8,8,346,31,76354,137,76868
2048,1,32,8,8,414,42,82642,147,83245
2048,1,32,8,8,348,31,73885,136,74400
2048,1,32,8,8,363,29,80371,141,80904
2048,2,16,8,8,350,31,87391,145,87917
2048,2,16,8,8,339,33,78329,172,78873
2048,2,16,8,8,346,29,85610,210,86195
2048,2,16,8,8,350,47,83019,170,83586
2048,2,16,8,8,339,34,81992,282,82647
2048,2,16,8,8,346,29,86018,140,86533
2048,2,16,8,8,338,29,81128,137,81632
2048,2,16,8,8,384,28,82808,139,83359
2048,2,16,8,8,347,29,79624,168,80168
2048,2,16,8,8,338,29,79978,194,80539
2048,4,8,8,8,338,30,83478,146,83992
2048,4,8,8,8,508,32,81748,162,82450
2048,4,8,8,8,346,31,85709,185,86271
2048,4,8,8,8,337,28,83576,143,84084
2048,4,8,8,8,338,29,83772,137,84276
2048,4,8,8,8,337,58,83577,139,84111
2048,4,8,8,8,337,28,83854,135,84354
2048,4,8,8,8,395,59,83848,187,84489
2048,4,8,8,8,358,30,85523,141,86052
2048,4,8,8,8,470,39,83520,181,84210
2048,8,4,8,8,346,29,81400,145,81920
2048,8,4,8,8,346,30,78126,179,78681
2048,8,4,8,8,349,39,80159,144,80691
2048,8,4,8,8,526,37,80878,196,81637
2048,8,4,8,8,366,34,80846,195,81441
2048,8,4,8,8,403,32,79253,163,79851
2048,8,4,8,8,347,39,81019,184,81589
2048,8,4,8,8,360,37,80641,144,81182
2048,8,4,8,8,396,37,79078,134,79645
2048,8,4,8,8,337,28,80990,134,81489
2048,16,2,8,8,338,29,83172,137,83676
2048,16,2,8,8,338,29,79192,137,79696
2048,16,2,8,8,337,40,80358,140,80875
2048,16,2,8,8,338,29,82489,150,83006
2048,16,2,8,8,344,30,82561,166,83101
2048,16,2,8,8,387,29,81082,155,81653
2048,16,2,8,8,346,30,83757,160,84293
2048,16,2,8,8,338,29,81348,154,81869
2048,16,2,8,8,338,30,83400,162,83930
2048,16,2,8,8,338,29,80445,174,80986
2048,32,1,8,8,338,34,82953,147,83472
2048,32,1,8,8,360,33,82548,194,83135
2048,32,1,8,8,439,42,84708,154,85343
2048,32,1,8,8,339,32,82787,142,83300
2048,32,1,8,8,419,43,83105,216,83783
2048,32,1,8,8,393,32,80295,214,80934
2048,32,1,8,8,378,31,84386,147,84942
2048,32,1,8,8,343,31,82562,185,83121
2048,32,1,8,8,429,34,80039,145,80647
2048,32,1,8,8,349,29,82610,139,83127
2048,1,64,4,8,338,28,78640,137,79143
2048,1,64,4,8,337,29,78348,138,78852
2048,1,64,4,8,338,28,81615,146,82127
2048,1,64,4,8,417,29,79240,173,79859
2048,1,64,4,8,513,74,79575,139,80301
2048,1,64,4,8,384,32,81114,138,81668
2048,1,64,4,8,397,36,80332,192,80957
2048,1,64,4,8,449,35,81886,142,82512
2048,1,64,4,8,337,29,83923,165,84454
2048,1,64,4,8,358,32,84749,161,85300
2048,2,32,4,8,506,32,81838,153,82529
2048,2,32,4,8,339,30,79014,169,79552
2048,2,32,4,8,393,43,83270,243,83949
2048,2,32,4,8,466,44,82143,173,82826
2048,2,32,4,8,338,29,83054,177,83598
2048,2,32,4,8,364,36,72928,150,73478
2048,2,32,4,8,347,30,77741,140,78258
2048,2,32,4,8,339,29,83033,137,83538
2048,2,32,4,8,338,30,86365,140,86873
2048,2,32,4,8,337,29,81254,141,81761
2048,4,16,4,8,338,31,82802,143,83314
2048,4,16,4,8,338,30,81804,150,82322
2048,4,16,4,8,338,31,83036,153,83558
2048,4,16,4,8,338,29,80870,180,81417
2048,4,16,4,8,338,36,81346,227,81947
2048,4,16,4,8,337,28,82332,243,82940
2048,4,16,4,8,338,28,86193,147,86706
2048,4,16,4,8,424,49,82032,147,82652
2048,4,16,4,8,338,29,78386,137,78890
2048,4,16,4,8,338,29,80676,140,81183
2048,8,8,4,8,338,29,84684,141,85192
2048,8,8,4,8,338,28,84720,139,85225
2048,8,8,4,8,338,29,84719,135,85221
2048,8,8,4,8,338,28,86745,227,87338
2048,8,8,4,8,338,30,86755,160,87283
2048,8,8,4,8,508,33,84521,138,85200
2048,8,8,4,8,337,29,82652,159,83177
2048,8,8,4,8,451,31,84723,148,85353
2048,8,8,4,8,507,30,85080,140,85757
2048,8,8,4,8,338,29,80799,155,81321
2048,16,4,4,8,511,30,80647,146,81334
2048,16,4,4,8,376,32,80690,162,81260
2048,16,4,4,8,361,36,84784,152,85333
2048,16,4,4,8,338,30,82768,207,83343
2048,16,4,4,8,369,35,79706,145,80255
2048,16,4,4,8,355,30,83769,139,84293
2048,16,4,4,8,338,29,81502,141,82010
2048,16,4,4,8,337,28,87067,137,87569
2048,16,4,4,8,337,28,85948,155,86468
2048,16,4,4,8,348,32,79689,138,80207
2048,32,2,4,8,337,29,85586,140,86092
2048,32,2,4,8,341,37,85364,159,85901
2048,32,2,4,8,338,28,84854,137,85357
2048,32,2,4,8,501,31,86511,207,87250
2048,32,2,4,8,337,29,86397,136,86899
2048,32,2,4,8,338,29,85076,146,85589
2048,32,2,4,8,632,64,87085,142,87923
2048,32,2,4,8,337,28,85805,143,86313
2048,32,2,4,8,338,28,84644,180,85190
2048,32,2,4,8,337,30,87096,142,87605
2048,64,1,4,8,337,28,74732,170,75267
2048,64,1,4,8,352,37,74972,140,75501
2048,64,1,4,8,347,35,72553,143,73078
2048,64,1,4,8,338,29,74725,192,75284
2048,64,1,4,8,399,36,72977,191,73603
2048,64,1,4,8,338,29,73902,137,74406
2048,64,1,4,8,338,29,74501,172,75040
2048,64,1,4,8,364,31,73809,140,74344
2048,64,1,4,8,341,29,73599,166,74135
2048,64,1,4,8,419,41,77153,141,77754
2048,1,128,4,4,337,29,81247,140,81753
2048,1,128,4,4,337,28,81250,137,81752
2048,1,128,4,4,337,29,81245,140,81751
2048,1,128,4,4,338,30,81913,152,82433
2048,1,128,4,4,338,33,83089,242,83702
2048,1,128,4,4,381,32,81257,147,81817
2048,1,128,4,4,338,29,82891,148,83406
2048,1,128,4,4,429,32,81255,338,82054
2048,1,128,4,4,350,32,81259,207,81848
2048,1,128,4,4,358,51,82755,248,83412
2048,2,64,4,4,337,28,81650,139,82154
2048,2,64,4,4,338,29,81658,175,82200
2048,2,64,4,4,337,28,80709,136,81210
2048,2,64,4,4,337,28,80698,139,81202
2048,2,64,4,4,337,29,78487,215,79068
2048,2,64,4,4,338,32,75652,141,76163
2048,2,64,4,4,338,29,86129,143,86639
2048,2,64,4,4,508,32,79285,202,80027
2048,2,64,4,4,487,43,81887,201,82618
2048,2,64,4,4,415,36,79319,141,79911
2048,4,32,4,4,337,28,75712,138,76215
2048,4,32,4,4,360,30,81452,159,82001
2048,4,32,4,4,346,29,75994,139,76508
2048,4,32,4,4,337,29,79522,144,80032
2048,4,32,4,4,346,29,77531,168,78074
2048,4,32,4,4,398,34,82021,169,82622
2048,4,32,4,4,379,32,80254,388,81053
2048,4,32,4,4,338,30,79124,219,79711
2048,4,32,4,4,338,31,82000,218,82587
2048,4,32,4,4,350,30,78413,139,78932
2048,8,16,4,4,346,29,78551,138,79064
2048,8,16,4,4,337,29,78543,137,79046
2048,8,16,4,4,415,28,85328,178,85949
2048,8,16,4,4,468,40,78649,148,79305
2048,8,16,4,4,337,29,81533,148,82047
2048,8,16,4,4,337,29,79278,137,79781
2048,8,16,4,4,338,29,78091,197,78655
2048,8,16,4,4,346,29,81001,139,81515
2048,8,16,4,4,388,29,76827,153,77397
2048,8,16,4,4,367,48,80482,140,81037
2048,16,8,4,4,337,28,88952,161,89478
2048,16,8,4,4,338,30,89229,141,89738
2048,16,8,4,4,346,30,81194,175,81745
2048,16,8,4,4,337,28,82533,139,83037
2048,16,8,4,4,337,29,80591,161,81118
2048,16,8,4,4,340,37,89422,134,89933
2048,16,8,4,4,338,29,83559,138,84064
2048,16,8,4,4,338,29,80005,147,80519
2048,16,8,4,4,338,29,88451,139,88957
2048,16,8,4,4,337,28,88459,140,88964
2048,32,4,4,4,392,44,83610,169,84215
2048,32,4,4,4,349,31,83065,144,83589
2048,32,4,4,4,337,29,88682,153,89201
2048,32,4,4,4,338,31,83847,168,84384
2048,32,4,4,4,338,30,82309,203,82880
2048,32,4,4,4,446,54,82297,154,82951
2048,32,4,4,4,337,30,86705,138,87210
2048,32,4,4,4,482,30,80672,154,81338
2048,32,4,4,4,338,31,82293,153,82815
2048,32,4,4,4,338,29,85329,134,85830
2048,64,2,4,4,338,28,77651,187,78204
2048,64,2,4,4,415,35,75729,160,76339
2048,64,2,4,4,347,55,79015,138,79555
2048,64,2,4,4,338,28,81997,160,82523
2048,64,2,4,4,338,29,77273,146,77786
2048,64,2,4,4,443,48,76655,175,77321
2048,64,2,4,4,346,30,77287,173,77836
2048,64,2,4,4,347,29,74934,141,75451
2048,64,2,4,4,384,29,83717,165,84295
2048,64,2,4,4,384,29,77386,140,77939
2048,128,1,4,4,337,29,79557,162,80085
2048,128,1,4,4,338,30,82487,150,83005
2048,128,1,4,4,390,37,75427,141,75995
2048,128,1,4,4,337,29,82793,147,83306
2048,128,1,4,4,338,29,82477,137,82981
2048,128,1,4,4,388,29,82482,138,83037
2048,128,1,4,4,337,29,82473,140,82979
2048,128,1,4,4,338,29,75438,138,75943
2048,128,1,4,4,382,29,83434,144,83989
2048,128,1,4,4,338,29,69967,161,70495
2048,1,256,2,4,370,46,54604,148,55168
2048,1,256,2,4,338,31,54607,133,55109
2048,1,256,2,4,337,28,63589,146,64100
2048,1,256,2,4,455,43,54601,141,55240
2048,1,256,2,4,346,39,54609,136,55130
2048,1,256,2,4,338,28,54607,171,55144
2048,1,256,2,4,338,36,54608,136,55118
2048,1,256,2,4,338,29,63526,151,64044
2048,1,256,2,4,1124,30,54608,134,55896
2048,1,256,2,4,338,28,54611,199,55176
2048,2,128,2,4,339,36,74437,136,74948
2048,2,128,2,4,338,29,73613,218,74198
2048,2,128,2,4,451,75,73475,142,74143
2048,2,128,2,4,337,29,54602,139,55107
2048,2,128,2,4,337,29,74622,179,75167
2048,2,128,2,4,422,33,54603,136,55194
2048,2,128,2,4,479,30,54597,134,55240
2048,2,128,2,4,337,29,73383,221,73970
2048,2,128,2,4,409,41,73713,141,74304
2048,2,128,2,4,338,29,65941,139,66447
2048,4,64,2,4,337,29,66069,138,66573
2048,4,64,2,4,337,28,54607,139,55111
2048,4,64,2,4,375,31,73624,147,74177
2048,4,64,2,4,393,30,73567,139,74129
2048,4,64,2,4,338,28,66393,133,66892
2048,4,64,2,4,337,29,74509,143,75018
2048,4,64,2,4,338,28,65286,140,65792
2048,4,64,2,4,338,29,74316,141,74824
2048,4,64,2,4,338,29,54605,180,55152
2048,4,64,2,4,399,91,74221,146,74857
2048,8,32,2,4,392,28,64750,138,65308
2048,8,32,2,4,338,30,73588,148,74104
2048,8,32,2,4,521,31,64387,206,65145
2048,8,32,2,4,338,30,64675,143,65186
2048,8,32,2,4,337,28,54604,142,55111
2048,8,32,2,4,338,28,54602,202,55170
2048,8,32,2,4,339,38,73358,136,73871
2048,8,32,2,4,423,28,65016,154,65621
2048,8,32,2,4,377,30,64400,151,64958
2048,8,32,2,4,516,31,74169,161,74877
2048,16,16,2,4,337,28,77384,154,77903
2048,16,16,2,4,338,30,78500,150,79018
2048,16,16,2,4,339,56,62003,136,62534
2048,16,16,2,4,337,29,78099,138,78603
2048,16,16,2,4,390,29,77694,204,78317
2048,16,16,2,4,577,57,73173,137,73944
2048,16,16,2,4,338,28,74187,139,74692
2048,16,16,2,4,338,29,73498,150,74015
2048,16,16,2,4,384,35,73400,176,73995
2048,16,16,2,4,346,29,77569,137,78081
2048,32,8,2,4,346,29,64164,145,64684
2048,32,8,2,4,338,31,60237,139,60745
2048,32,8,2,4,513,35,61647,145,62340
2048,32,8,2,4,338,31,61920,133,62422
2048,32,8,2,4,338,29,64293,133,64793
2048,32,8,2,4,337,29,55653,143,56162
2048,32,8,2,4,339,37,54582,152,55110
2048,32,8,2,4,606,47,64090,195,64938
2048,32,8,2,4,412,31,63848,205,64496
2048,32,8,2,4,510,33,59793,133,60469
2048,64,4,2,4,337,28,60784,134,61283
2048,64,4,2,4,350,30,61104,176,61660
2048,64,4,2,4,338,30,63510,178,64056
2048,64,4,2,4,339,31,61597,135,62102
2048,64,4,2,4,337,28,63402,140,63907
2048,64,4,2,4,338,29,56721,138,57226
2048,64,4,2,4,338,29,63177,170,63714
2048,64,4,2,4,337,29,62855,139,63360
2048,64,4,2,4,338,28,61015,155,61536
2048,64,4,2,4,338,31,63310,184,63863
2048,128,2,2,4,500,34,63181,154,63869
2048,128,2,2,4,347,33,63642,137,64159
2048,128,2,2,4,337,29,66426,141,66933
2048,128,2,2,4,337,28,65987,137,66489
2048,128,2,2,4,338,28,64478,138,64982
2048,128,2,2,4,338,28,67545,141,68052
2048,128,2,2,4,338,29,73371,259,73997
2048,128,2,2,4,345,42,65815,151,66353
2048,128,2,2,4,435,43,69475,186,70139
2048,128,2,2,4,357,32,62548,146,63083
2048,256,1,2,4,385,68,68852,148,69453
2048,256,1,2,4,357,32,68174,148,68711
2048,256,1,2,4,391,32,68377,136,68936
2048,256,1,2,4,337,29,68311,138,68815
2048,256,1,2,4,337,29,68789,173,69328
2048,256,1,2,4,460,48,66971,148,67627
2048,256,1,2,4,346,30,68438,163,68977
2048,256,1,2,4,346,30,68389,154,68919
2048,256,1,2,4,338,31,67995,279,68643
2048,256,1,2,4,347,36,69236,138,69757
4096,1,32,8,16,675,37,164732,176,165620
4096,1,32,8,16,676,39,171165,148,172028
4096,1,32,8,16,676,37,176609,179,177501
4096,1,32,8,16,751,39,172823,153,173766
4096,1,32,8,16,679,38,173371,171,174259
4096,1,32,8,16,732,41,162203,163,163139
4096,1,32,8,16,675,40,166685,162,167562
4096,1,32,8,16,675,37,171138,151,172001
4096,1,32,8,16,808,131,169103,186,170228
4096,1,32,8,16,756,37,169264,154,170211
4096,2,16,8,16,693,39,174776,185,175693
4096,2,16,8,16,688,36,172141,149,173014
4096,2,16,8,16,760,36,169821,258,170875
4096,2,16,8,16,856,48,180866,319,182089
4096,2,16,8,16,874,44,167006,168,168092
4096,2,16,8,16,692,38,175744,151,176625
4096,2,16,8,16,692,48,172168,175,173083
4096,2,16,8,16,675,40,168404,153,169272
4096,2,16,8,16,692,37,170524,334,171587
4096,2,16,8,16,682,52,168714,152,169600
4096,4,8,8,16,675,37,170741,149,171602
4096,4,8,8,16,675,37,170345,170,171227
4096,4,8,8,16,1016,85,162820,148,164069
4096,4,8,8,16,871,37,163805,154,164867
4096,4,8,8,16,675,36,167019,154,167884
4096,4,8,8,16,675,37,177631,152,178495
4096,4,8,8,16,675,36,170057,148,170916
4096,4,8,8,16,675,54,168621,284,169634
4096,4,8,8,16,818,40,161248,295,162401
4096,4,8,8,16,705,50,161195,166,162116
4096,8,4,8,16,958,95,170590,175,171818
4096,8,4,8,16,675,43,171555,155,172428
4096,8,4,8,16,675,36,172775,307,173793
4096,8,4,8,16,676,47,171026,150,171899
4096,8,4,8,16,994,52,170442,150,171638
4096,8,4,8,16,768,41,170630,180,171619
4096,8,4,8,16,686,41,168687,196,169610
4096,8,4,8,16,676,37,168394,192,169299
4096,8,4,8,16,675,37,167809,150,168671
4096,8,4,8,16,675,37,178342,150,179204
4096,16,2,8,16,675,37,169227,146,170085
4096,16,2,8,16,675,37,169237,150,170099
4096,16,2,8,16,1066,70,168547,169,169852
4096,16,2,8,16,676,38,165517,180,166411
4096,16,2,8,16,675,41,170576,151,171443
4096,16,2,8,16,675,36,169206,151,170068
4096,16,2,8,16,675,37,169337,151,170200
4096,16,2,8,16,675,37,168475,179,169366
4096,16,2,8,16,1049,41,168695,167,169952
4096,16,2,8,16,735,41,168452,149,169377
4096,32,1,8,16,1195,48,169517,151,170911
4096,32,1,8,16,721,37,173709,161,174628
4096,32,1,8,16,676,41,171522,153,172392
4096,32,1,8,16,675,37,171965,157,172834
4096,32,1,8,16,681,45,168924,161,169811
4096,32,1,8,16,676,39,175448,156,176319
4096,32,1,8,16,765,49,171623,154,172591
4096,32,1,8,16,684,38,170530,150,171402
4096,32,1,8,16,734,54,178594,150,179532
4096,32,1,8,16,675,37,175724,179,176615
4096,1,64,8,8,675,40,166278,158,167151
4096,1,64,8,8,719,42,168134,152,169047
4096,1,64,8,8,675,37,167676,151,168539
4096,1,64,8,8,675,36,167752,153,168616
4096,1,64,8,8,675,36,171328,158,172197
4096,1,64,8,8,694,38,165770,151,166653
4096,1,64,8,8,675,36,168384,160,169255
4096,1,64,8,8,692,38,167386,155,168271
4096,1,64,8,8,704,40,173112,167,174023
4096,1,64,8,8,999,53,168293,160,169505
4096,2,32,8,8,693,39,165668,188,166588
4096,2,32,8,8,805,49,166811,169,167834
4096,2,32,8,8,719,40,177758,152,178669
4096,2,32,8,8,692,37,167930,167,168826
4096,2,32,8,8,1148,76,166336,158,167718
4096,2,32,8,8,1013,61,164473,183,165730
4096,2,32,8,8,716,38,168494,171,169419
4096,2,32,8,8,1674,120,165495,151,167440
4096,2,32,8,8,692,38,179218,201,180149
4096,2,32,8,8,716,41,178297,148,179202
4096,4,16,8,8,678,49,179604,159,180490
4096,4,16,8,8,795,60,171509,176,172540
4096,4,16,8,8,676,43,167718,146,168583
4096,4,16,8,8,675,38,163861,172,164746
4096,4,16,8,8,675,37,171787,151,172650
4096,4,16,8,8,699,37,163484,154,164374
4096,4,16,8,8,675,37,167210,151,168073
4096,4,16,8,8,692,37,171238,201,172168
4096,4,16,8,8,695,38,165503,170,166406
4096,4,16,8,8,717,60,164668,163,165608
4096,8,8,8,8,888,37,170663,153,171741
4096,8,8,8,8,675,37,170427,190,171329
4096,8,8,8,8,902,55,168163,156,169276
4096,8,8,8,8,675,37,172943,154,173809
4096,8,8,8,8,801,58,174965,156,175980
4096,8,8,8,8,728,48,174276,156,175208
4096,8,8,8,8,703,38,168517,155,169413
4096,8,8,8,8,827,51,167944,182,169004
4096,8,8,8,8,976,49,175077,188,176290
4096,8,8,8,8,790,57,165295,154,166296
4096,16,4,8,8,692,38,167294,148,168172
4096,16,4,8,8,675,37,180538,153,181403
4096,16,4,8,8,852,39,172469,201,173561
4096,16,4,8,8,699,44,177699,149,178591
4096,16,4,8,8,697,45,177762,151,178655
4096,16,4,8,8,910,38,177007,178,178133
4096,16,4,8,8,701,38,179365,159,180263
4096,16,4,8,8,897,45,179705,151,180798
4096,16,4,8,8,692,37,175319,150,176198
4096,16,4,8,8,693,37,167401,151,168282
4096,32,2,8,8,692,38,183097,153,183980
4096,32,2,8,8,676,45,183201,192,184114
4096,32,2,8,8,1011,46,177614,310,178981
4096,32,2,8,8,692,37,177785,211,178725
4096,32,2,8,8,765,41,181205,152,182163
4096,32,2,8,8,692,37,169896,149,170774
4096,32,2,8,8,722,63,183366,261,184412
4096,32,2,8,8,711,39,178099,212,179061
4096,32,2,8,8,1011,44,183330,173,184558
4096,32,2,8,8,675,37,174994,157,175863
4096,64,1,8,8,987,74,179484,142,180687
4096,64,1,8,8,1024,107,178158,150,179439
4096,64,1,8,8,679,41,179664,204,180588
4096,64,1,8,8,677,40,183761,190,184668
4096,64,1,8,8,675,37,179995,176,180883
4096,64,1,8,8,675,37,182651,150,183513
4096,64,1,8,8,692,37,181162,189,182080
4096,64,1,8,8,719,37,177757,200,178713
4096,64,1,8,8,676,41,183547,173,184437
4096,64,1,8,8,693,38,175532,162,176425
4096,1,128,4,8,863,52,172894,158,173967
4096,1,128,4,8,675,37,176238,169,177119
4096,1,128,4,8,675,37,171958,150,172820
4096,1,128,4,8,692,38,176930,149,177809
4096,1,128,4,8,692,37,179653,166,180548
4096,1,128,4,8,692,38,166655,149,167534
4096,1,128,4,8,1038,48,173693,195,174974
4096,1,128,4,8,714,52,173115,148,174029
4096,1,128,4,8,681,37,170650,170,171538
4096,1,128,4,8,855,47,175329,148,176379
4096,2,64,4,8,732,37,180434,148,181351
4096,2,64,4,8,675,37,171453,177,172342
4096,2,64,4,8,865,67,170889,153,171974
4096,2,64,4,8,675,36,180441,154,181306
4096,2,64,4,8,888,38,186435,159,187520
4096,2,64,4,8,853,111,173531,153,174648
4096,2,64,4,8,750,39,175637,176,176602
4096,2,64,4,8,954,50,176363,159,177526
4096,2,64,4,8,718,44,178443,167,179372
4096,2,64,4,8,677,46,175206,163,176092
4096,4,32,4,8,678,40,174019,150,174887
4096,4,32,4,8,675,37,180081,179,180972
4096,4,32,4,8,914,47,184645,161,185767
4096,4,32,4,8,761,64,174155,150,175130
4096,4,32,4,8,688,37,174634,171,175530
4096,4,32,4,8,857,42,188847,152,189898
4096,4,32,4,8,825,63,175817,160,176865
4096,4,32,4,8,675,37,182628,149,183489
4096,4,32,4,8,693,37,177024,186,177940
4096,4,32,4,8,693,37,165599,157,166486
4096,8,16,4,8,675,36,178302,176,179189
4096,8,16,4,8,677,41,172749,153,173620
4096,8,16,4,8,675,37,176485,175,177372
4096,8,16,4,8,968,42,175021,150,176181
4096,8,16,4,8,825,42,182730,148,183745
4096,8,16,4,8,675,37,175103,147,175962
4096,8,16,4,8,738,40,175434,159,176371
4096,8,16,4,8,1212,58,182823,179,184272
4096,8,16,4,8,704,38,181995,200,182937
4096,8,16,4,8,907,40,173822,179,174948
4096,16,8,4,8,813,51,182221,154,183239
4096,16,8,4,8,994,42,187278,157,188471
4096,16,8,4,8,1010,61,179355,212,180638
4096,16,8,4,8,716,59,183443,213,184431
4096,16,8,4,8,929,44,183066,157,184196
4096,16,8,4,8,792,49,174617,154,175612
4096,16,8,4,8,990,49,178804,149,179992
4096,16,8,4,8,750,48,172744,154,173696
4096,16,8,4,8,675,37,185606,150,186468
4096,16,8,4,8,721,56,183685,376,184838
4096,32,4,4,8,998,42,185383,393,186816
4096,32,4,4,8,692,38,176341,149,177220
4096,32,4,4,8,829,39,178042,216,179126
4096,32,4,4,8,676,41,182464,173,183354
4096,32,4,4,8,693,40,180143,181,181057
4096,32,4,4,8,701,45,183192,161,184099
4096,32,4,4,8,675,40,181921,182,182818
4096,32,4,4,8,718,37,184227,152,185134
4096,32,4,4,8,764,37,174216,182,175199
4096,32,4,4,8,721,43,173147,160,174071
4096,64,2,4,8,692,37,181267,161,182157
4096,64,2,4,8,723,38,184271,153,185185
4096,64,2,4,8,675,37,174227,151,175090
4096,64,2,4,8,675,37,174345,150,175207
4096,64,2,4,8,931,77,179161,148,180317
4096,64,2,4,8,791,98,178577,186,179652
4096,64,2,4,8,677,43,174741,150,175611
4096,64,2,4,8,696,44,181072,148,181960
4096,64,2,4,8,963,51,177358,192,178564
4096,64,2,4,8,726,39,182977,156,183898
4096,128,1,4,8,989,53,181593,181,182816
4096,128,1,4,8,676,43,174917,152,175788
4096,128,1,4,8,692,38,175558,149,176437
4096,128,1,4,8,685,58,184808,152,185703
4096,128,1,4,8,675,37,181113,149,181974
4096,128,1,4,8,688,37,179527,152,180404
4096,128,1,4,8,750,39,181150,159,182098
4096,128,1,4,8,675,37,177740,154,178606
4096,128,1,4,8,1215,162,175166,147,176690
4096,128,1,4,8,675,36,173505,254,174470
4096,1,256,4,4,693,43,147908,171,148815
4096,1,256,4,4,694,42,147323,227,148286
4096,1,256,4,4,1103,48,149238,172,150561
4096,1,256,4,4,731,40,147021,229,148021
4096,1,256,4,4,692,37,155437,145,156311
4096,1,256,4,4,695,38,163877,153,164763
4096,1,256,4,4,687,42,163901,152,164782
4096,1,256,4,4,675,36,163917,150,164778
4096,1,256,4,4,675,37,163914,150,164776
4096,1,256,4,4,675,38,145124,155,145992
4096,2,128,4,4,731,43,161238,152,162164
4096,2,128,4,4,675,37,165494,152,166358
4096,2,128,4,4,675,36,161650,206,162567
4096,2,128,4,4,677,44,161229,180,162130
4096,2,128,4,4,696,42,161482,148,162368
4096,2,128,4,4,675,37,150532,151,151395
4096,2,128,4,4,706,55,161232,150,162143
4096,2,128,4,4,675,37,161481,187,162380
4096,2,128,4,4,693,38,166715,191,167637
4096,2,128,4,4,723,37,161254,156,162170
4096,4,64,4,4,692,38,162755,217,163702
4096,4,64,4,4,1077,53,163256,233,164619
4096,4,64,4,4,676,41,162639,145,163501
4096,4,64,4,4,736,43,160853,146,161778
4096,4,64,4,4,676,36,162587,150,163449
4096,4,64,4,4,722,38,162688,163,163611
4096,4,64,4,4,675,37,163968,194,164874
4096,4,64,4,4,712,40,163200,180,164132
4096,4,64,4,4,702,39,160506,219,161466
4096,4,64,4,4,799,73,162758,160,163790
4096,8,32,4,4,677,43,166950,343,168013
4096,8,32,4,4,783,39,166150,186,167158
4096,8,32,4,4,692,38,171296,157,172183
4096,8,32,4,4,675,39,166681,193,167588
4096,8,32,4,4,675,37,173213,244,174169
4096,8,32,4,4,743,50,171950,156,172899
4096,8,32,4,4,675,37,163285,173,164170
4096,8,32,4,4,848,42,178367,318,179575
4096,8,32,4,4,998,63,161914,159,163134
4096,8,32,4,4,787,53,164129,149,165118
4096,16,16,4,4,694,48,173806,155,174703
4096,16,16,4,4,675,37,168206,181,169099
4096,16,16,4,4,717,37,172826,151,173731
4096,16,16,4,4,676,40,174260,155,175131
4096,16,16,4,4,878,40,166360,154,167432
4096,16,16,4,4,692,38,168715,150,169595
4096,16,16,4,4,687,66,177628,153,178534
4096,16,16,4,4,675,37,179489,159,180360
4096,16,16,4,4,729,37,176358,199,177323
4096,16,16,4,4,740,42,169466,188,170436
4096,32,8,4,4,692,38,177632,295,178657
4096,32,8,4,4,693,42,173005,174,173914
4096,32,8,4,4,699,38,174003,151,174891
4096,32,8,4,4,675,37,177054,240,178006
4096,32,8,4,4,773,56,183572,208,184609
4096,32,8,4,4,676,43,168850,149,169718
4096,32,8,4,4,676,41,176733,241,177691
4096,32,8,4,4,679,52,176006,158,176895
4096,32,8,4,4,693,42,179308,261,180304
4096,32,8,4,4,699,66,181284,198,182247
4096,64,4,4,4,786,97,183522,161,184566
4096,64,4,4,4,694,42,178454,151,179341
4096,64,4,4,4,913,40,181984,152,183089
4096,64,4,4,4,695,42,177326,153,178216
4096,64,4,4,4,675,37,184057,150,184919
4096,64,4,4,4,675,36,178425,151,179287
4096,64,4,4,4,675,37,183102,152,183966
4096,64,4,4,4,675,36,183311,156,184178
4096,64,4,4,4,675,37,184336,149,185197
4096,64,4,4,4,675,37,178632,151,179495
4096,128,2,4,4,675,37,182092,193,182997
4096,128,2,4,4,723,38,183178,150,184089
4096,128,2,4,4,675,37,167117,153,167982
4096,128,2,4,4,676,40,174456,185,175357
4096,128,2,4,4,837,80,174004,155,175076
4096,128,2,4,4,692,37,174833,258,175820
4096,128,2,4,4,677,52,176108,154,176991
4096,128,2,4,4,675,36,167354,148,168213
4096,128,2,4,4,675,37,179852,159,180723
4096,128,2,4,4,700,44,172353,174,173271
4096,256,1,4,4,817,51,172424,193,173485
4096,256,1,4,4,729,38,168264,150,169181
4096,256,1,4,4,821,102,183195,170,184288
4096,256,1,4,4,993,41,173570,147,174751
4096,256,1,4,4,726,38,166901,148,167813
4096,256,1,4,4,738,93,169587,162,170580
4096,256,1,4,4,675,40,169802,152,170669
4096,256,1,4,4,694,40,171673,172,172579
4096,256,1,4,4,691,50,172233,149,173123
4096,256,1,4,4,675,37,167285,151,168148
8192,1,32,16,16,1397,50,614053,176,615676
8192,1,32,16,16,1392,67,608747,175,610381
8192,1,32,16,16,1349,48,608875,175,610447
8192,1,32,16,16,1796,77,614805,250,616928
8192,1,32,16,16,1350,60,556223,172,557805
8192,1,32,16,16,1394,50,610719,196,612359
8192,1,32,16,16,1387,51,611079,178,612695
8192,1,32,16,16,1984,55,614449,178,616666
8192,1,32,16,16,1384,48,611640,175,613247
8192,1,32,16,16,1927,96,631210,257,633490
8192,2,16,16,16,1995,52,615455,179,617681
8192,2,16,16,16,1509,51,614434,251,616245
8192,2,16,16,16,1361,49,611421,255,613086
8192,2,16,16,16,1349,49,579174,175,580747
8192,2,16,16,16,1384,48,610437,183,612052
8192,2,16,16,16,1379,54,615286,211,616930
8192,2,16,16,16,1420,49,612788,186,614443
8192,2,16,16,16,1569,50,508488,205,510312
8192,2,16,16,16,1349,47,581219,180,582795
8192,2,16,16,16,1405,49,572488,319,574261
8192,4,8,16,16,1856,84,568635,188,570763
8192,4,8,16,16,1397,74,610229,178,611878
8192,4,8,16,16,1393,50,609412,181,611036
8192,4,8,16,16,1357,68,560050,177,561652
8192,4,8,16,16,1589,121,609866,162,611738
8192,4,8,16,16,1349,48,617074,176,618647
8192,4,8,16,16,1422,48,578892,173,580535
8192,4,8,16,16,1349,48,612294,183,613874
8192,4,8,16,16,1431,51,521470,178,523130
8192,4,8,16,16,1659,49,570850,232,572790
8192,8,4,16,16,1350,49,551288,309,552996
8192,8,4,16,16,1536,68,612433,302,614339
8192,8,4,16,16,1385,48,610484,271,612188
8192,8,4,16,16,1399,50,606829,174,608452
8192,8,4,16,16,1398,48,605456,194,607096
8192,8,4,16,16,1350,50,623171,172,624743
8192,8,4,16,16,1398,49,615977,177,617601
8192,8,4,16,16,1366,51,618055,177,619649
8192,8,4,16,16,1448,49,608306,192,609995
8192,8,4,16,16,1416,55,559238,176,560885
8192,16,2,16,16,1799,83,612012,168,614062
8192,16,2,16,16,1574,102,616712,207,618595
8192,16,2,16,16,1400,49,621470,195,623114
8192,16,2,16,16,1451,53,637714,181,639399
8192,16,2,16,16,1434,78,627300,214,629026
8192,16,2,16,16,1468,59,611076,426,613029
8192,16,2,16,16,1350,48,607934,249,609581
8192,16,2,16,16,1455,55,628556,349,630415
8192,16,2,16,16,1410,82,614134,171,615797
8192,16,2,16,16,1538,119,580731,175,582563
8192,32,1,16,16,1416,49,597393,194,599052
8192,32,1,16,16,1352,48,592868,213,594481
8192,32,1,16,16,1406,59,610691,204,612360
8192,32,1,16,16,1385,48,620419,255,622107
8192,32,1,16,16,1392,49,612557,171,614169
8192,32,1,16,16,1349,48,607505,346,609248
8192,32,1,16,16,1443,55,625731,204,627433
8192,32,1,16,16,1485,70,613670,188,615413
8192,32,1,16,16,1388,50,620752,278,622468
8192,32,1,16,16,1617,68,619058,211,620954
8192,1,64,8,16,1398,64,478464,172,480098
8192,1,64,8,16,1349,47,459041,187,460624
8192,1,64,8,16,1349,48,459864,171,461432
8192,1,64,8,16,1400,49,459819,215,461483
8192,1,64,8,16,1350,61,474814,214,476439
8192,1,64,8,16,1385,61,480342,217,482005
8192,1,64,8,16,1350,48,465662,173,467233
8192,1,64,8,16,1349,47,462070,178,463644
8192,1,64,8,16,1392,48,458863,204,460507
8192,1,64,8,16,2351,65,457790,184,460390
8192,2,32,8,16,1349,48,459347,206,460950
8192,2,32,8,16,1566,60,444751,188,446565
8192,2,32,8,16,1509,88,450107,198,451902
8192,2,32,8,16,1371,61,448822,218,450472
8192,2,32,8,16,1516,169,444342,177,446204
8192,2,32,8,16,1390,48,440796,206,442440
8192,2,32,8,16,1403,78,442763,214,444458
8192,2,32,8,16,1388,49,459699,179,461315
8192,2,32,8,16,1349,48,452356,176,453929
8192,2,32,8,16,1461,62,470286,179,471988
8192,4,16,8,16,1385,48,449659,204,451296
8192,4,16,8,16,1384,48,460514,232,462178
8192,4,16,8,16,1351,62,454279,172,455864
8192,4,16,8,16,1399,49,450752,180,452380
8192,4,16,8,16,1350,48,459275,200,460873
8192,4,16,8,16,1394,49,456091,171,457705
8192,4,16,8,16,1349,49,465068,181,466647
8192,4,16,8,16,1840,60,447509,184,449593
8192,4,16,8,16,1350,62,457439,177,459028
8192,4,16,8,16,1415,48,450192,184,451839
8192,8,8,8,16,1820,83,474540,216,476659
8192,8,8,8,16,1413,52,451066,187,452718
8192,8,8,8,16,1413,52,478767,178,480410
8192,8,8,8,16,1350,48,449223,205,450826
8192,8,8,8,16,1385,48,467657,176,469266
8192,8,8,8,16,1405,62,451962,210,453639
8192,8,8,8,16,1351,66,445955,265,447637
8192,8,8,8,16,1361,64,468025,171,469621
8192,8,8,8,16,1349,47,461245,176,462817
8192,8,8,8,16,1394,48,447796,202,449440
8192,16,4,8,16,1350,48,460449,318,462165
8192,16,4,8,16,1970,70,458544,181,460765
8192,16,4,8,16,1424,52,451797,194,453467
8192,16,4,8,16,1384,48,470006,172,471610
8192,16,4,8,16,1803,49,461689,186,463727
8192,16,4,8,16,1394,49,473451,251,475145
8192,16,4,8,16,1997,78,463253,195,465523
8192,16,4,8,16,1415,54,468800,176,470445
8192,16,4,8,16,1349,48,453484,178,455059
8192,16,4,8,16,1508,90,460844,184,462626
8192,32,2,8,16,1538,144,456379,221,458282
8192,32,2,8,16,1386,54,475378,231,477049
8192,32,2,8,16,1349,51,474762,171,476333
8192,32,2,8,16,1397,47,454969,358,456771
8192,32,2,8,16,1562,55,469919,175,471711
8192,32,2,8,16,1349,48,463296,176,464869
8192,32,2,8,16,1350,48,450053,172,451623
8192,32,2,8,16,1423,61,454280,179,455943
8192,32,2,8,16,1538,53,451430,182,453203
8192,32,2,8,16,1386,55,448457,176,450074
8192,64,1,8,16,1411,49,444469,206,446135
8192,64,1,8,16,1406,52,423263,204,424925
8192,64,1,8,16,1350,60,452172,172,453754
8192,64,1,8,16,1401,60,458247,177,459885
8192,64,1,8,16,1391,64,459582,177,461214
8192,64,1,8,16,1532,124,447588,203,449447
8192,64,1,8,16,1350,47,440986,182,442565
8192,64,1,8,16,2232,75,443569,190,446066
8192,64,1,8,16,1350,48,444559,208,446165
8192,64,1,8,16,1350,54,428450,433,430287
8192,1,128,8,8,1352,54,464323,320,466049
8192,1,128,8,8,2043,51,467347,189,469630
8192,1,128,8,8,1540,66,462241,179,464026
8192,1,128,8,8,1544,52,484228,281,486105
8192,1,128,8,8,1394,49,472738,181,474362
8192,1,128,8,8,1438,68,479225,180,480911
8192,1,128,8,8,1349,66,460716,185,462316
8192,1,128,8,8,1500,52,470248,301,472101
8192,1,128,8,8,1392,57,459992,455,461896
8192,1,128,8,8,1448,53,467513,180,469194
8192,2,64,8,8,1392,49,477021,342,478804
8192,2,64,8,8,1400,56,469635,318,471409
8192,2,64,8,8,1385,49,477357,173,478964
8192,2,64,8,8,1386,48,479663,181,481278
8192,2,64,8,8,2283,75,462415,190,464963
8192,2,64,8,8,1394,51,464273,232,465950
8192,2,64,8,8,2003,67,469946,188,472204
8192,2,64,8,8,1349,47,498448,174,500018
8192,2,64,8,8,1349,47,482187,180,483763
8192,2,64,8,8,1632,229,464990,278,467129
8192,4,32,8,8,1379,52,480929,246,482606
8192,4,32,8,8,1385,48,477070,210,478713
8192,4,32,8,8,1450,112,489231,176,490969
8192,4,32,8,8,1595,90,494510,178,496373
8192,4,32,8,8,1385,49,466793,178,468405
8192,4,32,8,8,1393,68,470786,181,472428
8192,4,32,8,8,1745,92,476505,184,478526
8192,4,32,8,8,1545,108,483005,190,484848
8192,4,32,8,8,1351,71,464990,178,466590
8192,4,32,8,8,1385,49,475898,185,477517
8192,8,16,8,8,1384,49,511067,216,512716
8192,8,16,8,8,1441,52,488961,177,490631
8192,8,16,8,8,1349,48,481680,173,483250
8192,8,16,8,8,2261,67,500527,176,503031
8192,8,16,8,8,1350,47,502871,353,504621
8192,8,16,8,8,1453,76,491711,177,493417
8192,8,16,8,8,1749,104,499178,381,501412
8192,8,16,8,8,1463,48,469765,216,471492
8192,8,16,8,8,1385,49,492425,247,494106
8192,8,16,8,8,1400,50,504235,306,505991
8192,16,8,8,8,1423,84,475703,175,477385
8192,16,8,8,8,1428,118,493151,187,494884
8192,16,8,8,8,1351,52,473219,231,474853
8192,16,8,8,8,1384,50,469746,223,471403
8192,16,8,8,8,1452,125,467526,282,469385
8192,16,8,8,8,1395,49,463144,191,464779
8192,16,8,8,8,1786,143,468716,239,470884
8192,16,8,8,8,1384,50,469008,172,470614
8192,16,8,8,8,1397,49,477109,174,478729
8192,16,8,8,8,1371,50,455101,171,456693
8192,32,4,8,8,1384,48,467087,172,468691
8192,32,4,8,8,1408,48,455758,235,457449
8192,32,4,8,8,1598,50,426688,326,428662
8192,32,4,8,8,1406,53,437671,178,439308
8192,32,4,8,8,1466,101,436053,190,437810
8192,32,4,8,8,1513,87,459218,179,460997
8192,32,4,8,8,1699,67,446464,173,448403
8192,32,4,8,8,1393,48,438288,369,440098
8192,32,4,8,8,1398,59,442128,212,443797
8192,32,4,8,8,1672,93,445974,173,447912
8192,64,2,8,8,1743,108,445268,182,447301
8192,64,2,8,8,1430,90,465061,174,466755
8192,64,2,8,8,1726,163,465685,258,467832
8192,64,2,8,8,1788,80,463989,178,466035
8192,64,2,8,8,1555,50,458522,228,460355
8192,64,2,8,8,1526,84,458027,173,459810
8192,64,2,8,8,1385,53,448077,176,449691
8192,64,2,8,8,1350,48,429133,174,430705
8192,64,2,8,8,1543,51,463244,177,465015
8192,64,2,8,8,1385,49,460368,304,462106
8192,128,1,8,8,1398,56,425233,176,426863
8192,128,1,8,8,1515,55,428721,179,430470
8192,128,1,8,8,1384,48,432813,182,434427
8192,128,1,8,8,1384,50,453942,171,455547
8192,128,1,8,8,1404,91,436042,167,437704
8192,128,1,8,8,1351,50,433911,178,435490
8192,128,1,8,8,1473,51,456138,180,457842
8192,128,1,8,8,1731,58,438277,178,440244
8192,128,1,8,8,1912,72,439487,268,441739
8192,128,1,8,8,1349,48,426119,198,427714
8192,1,256,4,8,1833,63,371039,233,373168
8192,1,256,4,8,1721,119,384171,185,386196
8192,1,256,4,8,1604,57,443574,177,445412
8192,1,256,4,8,1732,57,425227,1234,428250
8192,1,256,4,8,1994,79,394888,239,397200
8192,1,256,4,8,1605,102,373637,260,375604
8192,1,256,4,8,1495,57,370857,174,372583
8192,1,256,4,8,1350,48,369560,216,371174
8192,1,256,4,8,1349,49,431240,175,432813
8192,1,256,4,8,2020,49,370932,192,373193
8192,2,128,4,8,1875,81,373210,207,375373
8192,2,128,4,8,1350,47,375210,181,376788
8192,2,128,4,8,1349,47,375560,258,377214
8192,2,128,4,8,1449,69,451264,266,453048
8192,2,128,4,8,1648,82,429092,217,431039
8192,2,128,4,8,1664,61,336356,1557,339638
8192,2,128,4,8,1384,48,337248,204,338884
8192,2,128,4,8,1349,47,374124,183,375703
8192,2,128,4,8,1475,57,372891,171,374594
8192,2,128,4,8,1385,63,427191,182,428821
8192,4,64,4,8,1547,58,411780,237,413622
8192,4,64,4,8,1455,68,422087,244,423854
8192,4,64,4,8,1433,49,411018,2556,415056
8192,4,64,4,8,2036,119,374064,252,376471
8192,4,64,4,8,1395,50,417866,181,419492
8192,4,64,4,8,2082,50,373853,260,376245
8192,4,64,4,8,1455,80,373749,15626,390910
8192,4,64,4,8,2452,66,405957,197,408672
8192,4,64,4,8,1406,70,327938,1078,330492
8192,4,64,4,8,1467,78,337237,198,338980
8192,8,32,4,8,1501,51,424770,177,426499
8192,8,32,4,8,1406,121,418264,240,420031
8192,8,32,4,8,1801,79,434168,262,436310
8192,8,32,4,8,1408,57,442654,192,444311
8192,8,32,4,8,1422,83,425505,207,427217
8192,8,32,4,8,1401,49,424760,229,426439
8192,8,32,4,8,1670,63,397241,177,399151
8192,8,32,4,8,1384,48,443227,175,444834
8192,8,32,4,8,1386,49,399674,178,401287
8192,8,32,4,8,1399,49,455201,218,456867
8192,16,16,4,8,1400,49,455652,219,457320
8192,16,16,4,8,1384,49,433307,176,434916
8192,16,16,4,8,1442,74,422008,184,423708
8192,16,16,4,8,1747,92,433271,265,435375
8192,16,16,4,8,1748,59,448096,178,450081
8192,16,16,4,8,1655,163,448017,187,450022
8192,16,16,4,8,1349,48,434857,174,436428
8192,16,16,4,8,1513,118,450679,190,452500
8192,16,16,4,8,1385,49,416179,180,417793
8192,16,16,4,8,1398,55,426005,174,427632
8192,32,8,4,8,1387,48,466120,173,467728
8192,32,8,4,8,1385,51,432489,174,434099
8192,32,8,4,8,1664,158,436095,223,438140
8192,32,8,4,8,1396,48,436048,179,437671
8192,32,8,4,8,1871,63,449320,176,451430
8192,32,8,4,8,1400,49,443489,174,445112
8192,32,8,4,8,1352,48,443905,175,445480
8192,32,8,4,8,1583,67,435372,222,437244
8192,32,8,4,8,1351,52,430255,194,431852
8192,32,8,4,8,1610,79,443459,223,445371
8192,64,4,4,8,1537,93,459559,177,461366
8192,64,4,4,8,1367,49,432017,180,433613
8192,64,4,4,8,1350,50,456704,175,458279
8192,64,4,4,8,2070,57,449702,182,452011
8192,64,4,4,8,1404,48,442928,177,444557
8192,64,4,4,8,1363,49,450590,186,452188
8192,64,4,4,8,1467,68,455466,180,457181
8192,64,4,4,8,1384,49,443681,2426,447540
8192,64,4,4,8,1527,51,462406,181,464165
8192,64,4,4,8,1415,50,441722,274,443461
8192,128,2,4,8,1350,48,431185,194,432777
8192,128,2,4,8,1600,49,419895,173,421717
8192,128,2,4,8,1825,106,458590,175,460696
8192,128,2,4,8,1389,66,419607,242,421304
8192,128,2,4,8,1458,54,390083,205,391800
8192,128,2,4,8,1397,49,441332,211,442989
8192,128,2,4,8,1418,48,416628,174,418268
8192,128,2,4,8,1757,95,414326,295,416473
8192,128,2,4,8,1655,85,394972,179,396891
8192,128,2,4,8,1396,87,431899,232,433614
8192,256,1,4,8,1456,49,327143,3838,332486
8192,256,1,4,8,1384,48,409492,184,411108
8192,256,1,4,8,1350,48,448054,166,449618
8192,256,1,4,8,1437,50,440441,211,442139
8192,256,1,4,8,1445,72,388204,175,389896
8192,256,1,4,8,1349,49,439658,173,441229
8192,256,1,4,8,1350,47,395152,175,396724
8192,256,1,4,8,1349,47,436566,241,438203
8192,256,1,4,8,1448,65,374078,177,375768
8192,256,1,4,8,1349,48,404986,174,406557
