32,32,1,6,22,726,75,829
32,32,1,5,22,726,78,831
32,32,1,8,25,727,96,856
32,32,1,6,24,727,77,834
32,32,1,5,24,727,93,849
32,32,1,5,22,726,72,825
32,32,1,8,32,732,109,881
32,32,1,8,24,728,84,844
32,32,1,6,22,726,75,829
32,32,1,5,22,726,72,825
32,64,1,5,21,725,73,824
32,64,1,7,27,732,136,902
32,64,1,9,24,746,99,878
32,64,1,5,22,725,74,826
32,64,1,10,40,739,160,949
32,64,1,6,22,726,73,827
32,64,1,7,34,731,183,955
32,64,1,6,23,726,84,839
32,64,1,8,25,727,78,838
32,64,1,5,22,726,79,832
32,128,1,5,23,727,76,831
32,128,1,5,21,726,71,823
32,128,1,5,22,727,76,830
32,128,1,5,22,726,77,830
32,128,1,5,22,726,74,827
32,128,1,6,33,737,105,881
32,128,1,5,23,731,83,842
32,128,1,5,22,726,75,828
32,128,1,6,21,726,75,828
32,128,1,5,21,727,74,827
32,256,1,5,22,726,72,825
32,256,1,5,22,936,71,1034
32,256,1,6,23,937,73,1039
32,256,1,6,22,936,80,1044
32,256,1,6,23,941,238,1208
32,256,1,5,24,938,88,1055
32,256,1,5,23,939,77,1044
32,256,1,6,22,937,78,1043
32,256,1,6,22,937,78,1043
32,256,1,5,22,937,91,1055
64,32,2,11,22,1605,73,1711
64,32,2,11,23,1609,82,1725
64,32,2,11,22,1605,75,1713
64,32,2,11,24,1611,151,1797
64,32,2,11,24,1607,107,1749
64,32,2,11,23,1606,80,1720
64,32,2,11,22,1606,77,1716
64,32,2,11,22,1606,77,1716
64,32,2,11,21,1605,73,1710
64,32,2,11,22,1605,75,1713
64,64,1,11,22,1570,154,1757
64,64,1,12,50,1596,161,1819
64,64,1,11,22,1569,92,1694
64,64,1,11,22,1568,78,1679
64,64,1,11,23,1569,100,1703
64,64,1,11,23,1570,101,1705
64,64,1,11,24,1569,92,1696
64,64,1,11,23,1568,85,1687
64,64,1,11,22,1568,76,1677
64,64,1,11,22,1567,75,1675
64,128,1,11,22,1568,100,1701
64,128,1,11,23,1568,77,1679
64,128,1,11,21,1569,118,1719
64,128,1,11,24,1569,90,1694
64,128,1,11,22,1567,78,1678
64,128,1,11,22,1567,75,1675
64,128,1,11,22,1568,73,1674
64,128,1,11,22,1567,86,1686
64,128,1,11,27,1575,146,1759
64,128,1,11,24,1568,79,1682
64,256,1,11,21,1568,95,1695
64,256,1,11,23,1577,259,1870
64,256,1,11,34,1575,126,1746
64,256,1,11,24,1569,79,1683
64,256,1,11,22,1567,75,1675
64,256,1,11,23,1568,74,1676
64,256,1,11,22,1568,87,1688
64,256,1,14,31,1577,152,1774
64,256,1,16,23,1568,81,1688
64,256,1,11,22,1567,80,1680
128,32,4,22,23,2943,76,3064
128,32,4,22,22,2947,149,3140
128,32,4,31,25,2949,92,3097
128,32,4,22,23,2943,78,3066
128,32,4,22,22,2948,78,3070
128,32,4,21,23,2947,174,3165
128,32,4,24,23,2944,83,3074
128,32,4,28,29,2947,80,3084
128,32,4,22,22,2948,162,3154
128,32,4,26,24,2944,93,3087
128,64,2,21,22,2874,76,2993
128,64,2,22,22,2875,76,2995
128,64,2,22,22,2876,146,3066
128,64,2,21,26,2879,130,3056
128,64,2,38,30,2882,160,3110
128,64,2,21,22,2885,78,3006
128,64,2,22,23,2874,79,2998
128,64,2,22,22,2874,76,2994
128,64,2,21,22,2873,73,2989
128,64,2,22,22,2881,257,3182
128,128,1,22,24,2838,128,3012
128,128,1,22,22,2835,79,2958
128,128,1,22,22,2840,76,2960
128,128,1,21,22,2834,77,2954
128,128,1,21,23,2852,164,3060
128,128,1,21,23,2837,80,2961
128,128,1,30,28,2840,136,3034
128,128,1,22,23,2836,74,2955
128,128,1,21,22,2837,93,2973
128,128,1,22,22,2839,151,3034
128,256,1,22,23,2836,81,2962
128,256,1,21,22,2835,100,2978
128,256,1,22,23,2835,75,2955
128,256,1,21,24,2840,151,3036
128,256,1,21,24,2837,86,2968
128,256,1,21,22,2835,75,2953
128,256,1,21,22,2843,80,2966
128,256,1,21,25,2838,197,3081
128,256,1,26,31,2839,105,3001
128,256,1,21,23,2835,77,2956
256,32,8,43,23,5631,80,5777
256,32,8,43,23,5643,224,5933
256,32,8,43,23,5633,88,5787
256,32,8,42,22,5634,85,5783
256,32,8,44,27,5635,118,5824
256,32,8,43,23,5632,88,5786
256,32,8,43,24,5632,92,5791
256,32,8,44,29,5640,159,5872
256,32,8,44,23,5629,77,5773
256,32,8,42,22,5637,145,5846
256,64,4,42,24,5491,134,5691
256,64,4,43,23,5489,80,5635
256,64,4,56,29,5490,136,5711
256,64,4,43,23,5488,95,5649
256,64,4,55,25,5495,136,5711
256,64,4,43,26,5525,135,5729
256,64,4,42,23,5488,76,5629
256,64,4,42,22,5491,204,5759
256,64,4,61,23,5492,141,5717
256,64,4,62,27,5490,90,5669
256,128,2,43,22,5417,74,5556
256,128,2,42,22,5421,117,5602
256,128,2,52,24,5419,78,5573
256,128,2,42,22,5421,73,5558
256,128,2,42,22,5421,184,5669
256,128,2,57,57,5422,89,5625
256,128,2,44,23,5426,157,5650
256,128,2,82,63,5424,117,5686
256,128,2,42,22,5416,76,5556
256,128,2,42,22,5448,247,5759
256,256,1,42,24,5484,92,5642
256,256,1,42,23,5483,75,5623
256,256,1,42,22,5484,127,5675
256,256,1,52,40,5489,125,5706
256,256,1,42,23,5482,75,5622
256,256,1,43,27,5488,224,5782
256,256,1,42,24,5483,81,5630
256,256,1,43,22,5484,113,5662
256,256,1,43,26,5487,125,5681
256,256,1,42,23,5482,79,5626
512,32,16,84,22,11037,135,11278
512,32,16,84,26,11033,82,11225
512,32,16,85,25,11040,171,11321
512,32,16,85,23,11041,130,11279
512,32,16,142,25,11026,150,11343
512,32,16,84,24,11027,112,11247
512,32,16,87,24,11037,126,11274
512,32,16,84,22,11026,130,11262
512,32,16,87,26,11045,264,11422
512,32,16,87,26,11030,117,11260
512,64,8,84,23,10727,134,10968
512,64,8,84,26,10726,154,10990
512,64,8,129,43,10742,124,11038
512,64,8,160,35,10744,193,11132
512,64,8,85,23,10730,135,10973
512,64,8,91,25,10728,164,11008
512,64,8,85,23,10724,93,10925
512,64,8,132,24,10732,130,11018
512,64,8,84,22,10730,140,10976
512,64,8,125,25,10736,103,10989
512,128,4,84,22,10584,128,10818
512,128,4,84,23,10586,231,10924
512,128,4,87,43,10584,113,10827
512,128,4,84,24,10581,129,10818
512,128,4,85,23,10578,84,10770
512,128,4,122,29,10584,115,10850
512,128,4,84,23,10580,125,10812
512,128,4,84,24,10584,144,10836
512,128,4,95,24,10576,89,10784
512,128,4,120,52,10594,129,10895
512,256,2,87,24,10669,132,10912
512,256,2,85,23,10667,242,11017
512,256,2,102,25,10668,117,10912
512,256,2,147,31,10669,130,10977
512,256,2,87,24,10666,134,10911
512,256,2,87,26,10665,100,10878
512,256,2,85,25,10664,172,10946
512,256,2,107,24,10667,133,10931
512,256,2,127,24,10662,159,10972
512,256,2,86,30,10668,126,10910
1024,32,32,169,26,22086,237,22518
1024,32,32,169,27,22087,130,22413
1024,32,32,169,25,22089,129,22412
1024,32,32,335,32,22088,150,22605
1024,32,32,169,25,22080,130,22404
1024,32,32,169,26,22081,145,22421
1024,32,32,169,27,22082,130,22408
1024,32,32,169,26,22091,218,22504
1024,32,32,169,26,22082,136,22413
1024,32,32,187,26,22086,200,22499
1024,64,16,257,28,21507,136,21928
1024,64,16,204,26,21506,158,21894
1024,64,16,189,30,21506,129,21854
1024,64,16,169,26,21517,133,21845
1024,64,16,169,26,21513,132,21840
1024,64,16,173,26,21510,134,21843
1024,64,16,169,25,21505,171,21870
1024,64,16,169,26,21508,136,21839
1024,64,16,173,26,21505,187,21891
1024,64,16,169,28,21513,132,21842
1024,128,8,169,26,21154,139,21488
1024,128,8,241,26,21155,162,21584
1024,128,8,254,29,21147,150,21580
1024,128,8,222,26,21151,160,21559
1024,128,8,253,28,21156,132,21569
1024,128,8,169,26,21159,185,21539
1024,128,8,170,28,21224,146,21568
1024,128,8,169,27,21148,127,21471
1024,128,8,173,25,21167,132,21497
1024,128,8,261,92,21150,150,21653
1024,256,4,169,26,21040,132,21367
1024,256,4,169,25,21041,131,21366
1024,256,4,169,26,21040,142,21377
1024,256,4,173,27,21038,143,21381
1024,256,4,185,30,21036,135,21386
1024,256,4,169,26,21041,129,21365
1024,256,4,207,49,21040,139,21435
1024,256,4,169,28,21034,137,21368
1024,256,4,185,26,21038,127,21376
1024,256,4,170,30,21034,161,21395
2048,32,64,414,32,45742,206,46394
2048,32,64,338,31,41798,141,42308
2048,32,64,337,29,41809,179,42354
2048,32,64,385,32,41799,138,42354
2048,32,64,338,29,40624,129,41120
2048,32,64,348,32,36104,194,36678
2048,32,64,338,30,36103,136,36607
2048,32,64,346,30,36099,137,36612
2048,32,64,417,28,36106,204,36755
2048,32,64,508,33,34589,193,35323
2048,64,32,356,35,33675,145,34211
2048,64,32,391,29,33670,135,34225
2048,64,32,346,29,33672,137,34184
2048,64,32,346,29,33670,137,34182
2048,64,32,485,29,33676,139,34329
2048,64,32,337,28,33674,136,34175
2048,64,32,337,29,33671,135,34172
2048,64,32,346,29,33669,135,34179
2048,64,32,346,29,33670,138,34183
2048,64,32,346,29,33670,134,34179
2048,128,16,347,29,33155,140,33671
2048,128,16,346,29,33157,138,33670
2048,128,16,337,28,33152,136,33653
2048,128,16,338,28,33155,139,33660
2048,128,16,337,29,33152,142,33660
2048,128,16,338,29,33152,136,33655
2048,128,16,428,75,33187,184,33874
2048,128,16,342,31,33153,153,33679
2048,128,16,337,28,33396,139,33900
2048,128,16,360,30,33397,140,33927
2048,256,8,337,28,33168,139,33672
2048,256,8,508,30,33174,134,33846
2048,256,8,337,30,33168,137,33672
2048,256,8,337,29,33169,136,33671
2048,256,8,346,29,33165,144,33684
2048,256,8,392,33,33172,169,33766
2048,256,8,400,33,33172,147,33752
2048,256,8,381,31,33167,140,33719
2048,256,8,481,38,33176,144,33839
2048,256,8,375,31,33170,143,33719
4096,32,128,879,50,84254,155,85338
4096,32,128,706,38,84253,157,85154
4096,32,128,817,64,84669,175,85725
4096,32,128,692,41,84662,154,85549
4096,32,128,700,39,84652,151,85542
4096,32,128,675,37,84645,147,85504
4096,32,128,675,37,84643,148,85503
4096,32,128,675,51,84652,182,85560
4096,32,128,825,100,84660,170,85755
4096,32,128,800,51,84659,176,85686
4096,64,64,1015,39,83313,150,84517
4096,64,64,681,39,83316,170,84206
4096,64,64,751,41,83297,232,84321
4096,64,64,726,38,83300,222,84286
4096,64,64,824,56,83328,213,84421
4096,64,64,710,86,83317,173,84286
4096,64,64,1097,54,83303,185,84639
4096,64,64,675,37,83301,160,84173
4096,64,64,675,61,83300,151,84187
4096,64,64,675,37,83309,153,84174
4096,128,32,674,37,82800,155,83666
4096,128,32,723,40,82786,148,83697
4096,128,32,675,36,82784,149,83644
4096,128,32,675,37,82800,143,83655
4096,128,32,679,37,82813,149,83678
4096,128,32,675,37,82798,156,83666
4096,128,32,707,55,82775,154,83691
4096,128,32,675,37,82817,146,83675
4096,128,32,720,37,82778,153,83688
4096,128,32,675,38,82786,152,83651
4096,256,16,725,38,91782,329,92874
4096,256,16,679,40,91775,146,92640
4096,256,16,675,37,91769,162,92643
4096,256,16,692,38,91766,151,92647
4096,256,16,675,37,91769,194,92675
4096,256,16,791,54,91752,150,92747
4096,256,16,686,38,91782,179,92685
4096,256,16,776,42,91778,151,92747
4096,256,16,676,42,91781,148,92647
4096,256,16,727,38,91762,147,92674
8192,32,256,1405,73,378347,178,380003
8192,32,256,1431,50,380579,196,382256
8192,32,256,1451,51,361585,257,363344
8192,32,256,1357,72,381249,179,382857
8192,32,256,1364,69,380049,207,381689
8192,32,256,1447,79,382154,291,383971
8192,32,256,2019,68,381412,189,383688
8192,32,256,1419,50,380280,180,381929
8192,32,256,1802,99,379947,171,382019
8192,32,256,1350,51,379950,173,381524
8192,64,128,1400,49,298825,176,300450
8192,64,128,1429,56,299654,186,301325
8192,64,128,1807,116,299633,249,301805
8192,64,128,1448,99,299628,224,301399
8192,64,128,1523,110,299652,248,301533
8192,64,128,1626,79,299639,254,301598
8192,64,128,2394,72,299619,179,302264
8192,64,128,1353,47,299613,178,301191
8192,64,128,1393,49,299645,176,301263
8192,64,128,1350,48,299606,174,301178
8192,128,64,1349,48,297584,173,299154
8192,128,64,1352,47,296492,205,298096
8192,128,64,1383,48,297457,188,299076
8192,128,64,1360,49,297503,213,299125
8192,128,64,1595,64,297498,225,299382
8192,128,64,1428,54,297469,172,299123
8192,128,64,1350,48,297483,209,299090
8192,128,64,1398,49,297482,201,299130
8192,128,64,1349,49,297525,235,299158
8192,128,64,1401,66,297499,188,299154
8192,256,32,1350,48,321329,443,323170
8192,256,32,1401,74,321342,172,322989
8192,256,32,1350,48,321318,182,322898
8192,256,32,1521,49,321206,224,323000
8192,256,32,1423,68,321297,171,322959
8192,256,32,1416,77,321358,321,323172
8192,256,32,2048,70,321329,174,323621
8192,256,32,1349,48,321304,197,322898
8192,256,32,1957,77,320321,182,322537
8192,256,32,1385,50,320375,239,322049
