32,1,32,1,1,6,22,863,76,967
32,1,32,1,1,6,23,863,84,976
32,1,32,1,1,6,24,867,182,1079
32,1,32,1,1,6,24,863,88,981
32,1,32,1,1,5,23,864,78,970
32,1,32,1,1,7,22,863,79,971
32,1,32,1,1,7,22,862,82,973
32,1,32,1,1,9,24,864,85,982
32,1,32,1,1,6,32,871,141,1050
32,1,32,1,1,6,23,863,96,988
32,2,16,1,1,5,22,877,84,988
32,2,16,1,1,5,22,876,75,978
32,2,16,1,1,5,22,876,74,977
32,2,16,1,1,5,22,877,75,979
32,2,16,1,1,9,32,889,142,1072
32,2,16,1,1,12,34,884,135,1065
32,2,16,1,1,6,26,879,88,999
32,2,16,1,1,6,26,883,149,1064
32,2,16,1,1,6,23,879,92,1000
32,2,16,1,1,6,24,877,82,989
32,4,8,1,1,5,24,888,82,999
32,4,8,1,1,6,22,888,74,990
32,4,8,1,1,6,22,892,74,994
32,4,8,1,1,6,22,888,76,992
32,4,8,1,1,6,21,907,93,1027
32,4,8,1,1,6,28,895,198,1127
32,4,8,1,1,6,24,891,110,1031
32,4,8,1,1,6,25,892,115,1038
32,4,8,1,1,5,24,894,91,1014
32,4,8,1,1,6,22,888,75,991
32,8,4,1,1,5,22,916,76,1019
32,8,4,1,1,5,22,911,74,1012
32,8,4,1,1,5,22,911,74,1012
32,8,4,1,1,5,22,911,74,1012
32,8,4,1,1,5,23,915,193,1136
32,8,4,1,1,34,22,912,88,1056
32,8,4,1,1,6,23,912,78,1019
32,8,4,1,1,6,23,926,92,1047
32,8,4,1,1,6,26,915,106,1053
32,8,4,1,1,6,24,914,91,1035
32,16,2,1,1,6,22,958,78,1064
32,16,2,1,1,6,22,959,79,1066
32,16,2,1,1,5,22,958,77,1062
32,16,2,1,1,5,21,959,81,1066
32,16,2,1,1,5,21,958,72,1056
32,16,2,1,1,5,22,960,291,1278
32,16,2,1,1,6,23,960,110,1099
32,16,2,1,1,6,24,961,117,1108
32,16,2,1,1,6,22,959,93,1080
32,16,2,1,1,6,23,960,82,1071
32,32,1,1,1,5,22,1054,78,1159
32,32,1,1,1,6,22,1054,74,1156
32,32,1,1,1,5,21,1055,74,1155
32,32,1,1,1,6,22,1054,76,1158
32,32,1,1,1,5,22,1054,75,1156
32,32,1,1,1,6,28,1060,126,1220
32,32,1,1,1,7,29,1060,113,1209
32,32,1,1,1,6,23,1055,90,1174
32,32,1,1,1,6,23,1055,78,1162
32,32,1,1,1,5,22,1054,75,1156
32,1,64,1,1,5,21,872,80,978
32,1,64,1,1,6,22,871,75,974
32,1,64,1,1,6,22,872,77,977
32,1,64,1,1,5,22,872,73,972
32,1,64,1,1,6,22,872,87,987
32,1,64,1,1,6,24,874,86,990
32,1,64,1,1,5,23,873,80,981
32,1,64,1,1,5,22,872,77,976
32,1,64,1,1,6,35,872,76,989
32,1,64,1,1,5,22,872,73,972
32,2,32,1,1,5,22,886,77,990
32,2,32,1,1,6,23,890,104,1023
32,2,32,1,1,6,24,886,88,1004
32,2,32,1,1,5,22,889,93,1009
32,2,32,1,1,5,24,886,79,994
32,2,32,1,1,6,23,886,77,992
32,2,32,1,1,5,22,885,75,987
32,2,32,1,1,5,21,887,75,988
32,2,32,1,1,5,22,885,75,987
32,2,32,1,1,5,22,885,73,985
32,4,16,1,1,6,21,897,86,1010
32,4,16,1,1,6,25,903,117,1051
32,4,16,1,1,7,28,904,104,1043
32,4,16,1,1,6,23,898,87,1014
32,4,16,1,1,6,22,898,81,1007
32,4,16,1,1,8,24,899,84,1015
32,4,16,1,1,6,22,898,88,1014
32,4,16,1,1,6,22,898,76,1002
32,4,16,1,1,6,22,897,75,1000
32,4,16,1,1,5,22,901,75,1003
32,8,8,1,1,5,22,920,74,1021
32,8,8,1,1,6,26,924,154,1110
32,8,8,1,1,8,25,943,131,1107
32,8,8,1,1,8,24,922,83,1037
32,8,8,1,1,8,23,921,80,1032
32,8,8,1,1,5,21,921,74,1021
32,8,8,1,1,6,22,920,76,1024
32,8,8,1,1,6,29,925,100,1060
32,8,8,1,1,6,24,923,99,1052
32,8,8,1,1,6,22,920,91,1039
32,16,4,1,1,6,22,967,89,1084
32,16,4,1,1,6,23,968,80,1077
32,16,4,1,1,5,22,967,74,1068
32,16,4,1,1,5,22,968,77,1072
32,16,4,1,1,5,21,966,79,1071
32,16,4,1,1,5,22,967,74,1068
32,16,4,1,1,5,22,971,76,1074
32,16,4,1,1,5,22,968,76,1071
32,16,4,1,1,6,25,972,139,1142
32,16,4,1,1,6,24,973,105,1108
32,32,2,1,1,6,24,1064,100,1194
32,32,2,1,1,6,23,1062,80,1171
32,32,2,1,1,5,22,1062,75,1164
32,32,2,1,1,5,22,1061,76,1164
32,32,2,1,1,5,21,1061,73,1160
32,32,2,1,1,6,22,1061,74,1163
32,32,2,1,1,5,21,1061,74,1161
32,32,2,1,1,6,22,1061,78,1167
32,32,2,1,1,5,22,1063,100,1190
32,32,2,1,1,6,40,1063,87,1196
32,64,1,1,1,5,22,1054,75,1156
32,64,1,1,1,5,22,1054,75,1156
32,64,1,1,1,5,21,1054,77,1157
32,64,1,1,1,7,22,1059,76,1164
32,64,1,1,1,5,22,1054,74,1155
32,64,1,1,1,6,21,1054,73,1154
32,64,1,1,1,5,22,1054,75,1156
32,64,1,1,1,5,21,1055,81,1162
32,64,1,1,1,5,22,1054,74,1155
32,64,1,1,1,5,22,1054,72,1153
32,1,128,1,1,5,21,861,76,963
32,1,128,1,1,5,22,860,72,959
32,1,128,1,1,5,22,860,76,963
32,1,128,1,1,6,22,863,122,1013
32,1,128,1,1,8,24,864,99,995
32,1,128,1,1,6,23,862,100,991
32,1,128,1,1,6,24,865,105,1000
32,1,128,1,1,6,27,867,106,1006
32,1,128,1,1,6,26,867,97,996
32,1,128,1,1,6,22,861,79,968
32,2,64,1,1,6,22,875,110,1013
32,2,64,1,1,5,22,875,75,977
32,2,64,1,1,8,23,876,78,985
32,2,64,1,1,6,22,875,104,1007
32,2,64,1,1,6,22,875,102,1005
32,2,64,1,1,6,22,875,94,997
32,2,64,1,1,5,21,875,78,979
32,2,64,1,1,6,25,875,83,989
32,2,64,1,1,5,22,876,81,984
32,2,64,1,1,6,22,875,88,991
32,4,32,1,1,8,25,888,83,1004
32,4,32,1,1,5,22,886,77,990
32,4,32,1,1,5,22,886,73,986
32,4,32,1,1,5,22,886,75,988
32,4,32,1,1,5,22,1145,74,1246
32,4,32,1,1,6,21,1145,74,1246
32,4,32,1,1,6,22,1144,81,1253
32,4,32,1,1,5,21,1144,75,1245
32,4,32,1,1,10,29,1149,91,1279
32,4,32,1,1,5,22,1145,86,1258
32,8,16,1,1,6,24,1177,91,1298
32,8,16,1,1,5,23,1175,86,1289
32,8,16,1,1,6,39,1175,79,1299
32,8,16,1,1,5,22,1175,76,1278
32,8,16,1,1,6,23,1177,111,1317
32,8,16,1,1,6,22,1176,76,1280
32,8,16,1,1,5,22,1175,73,1275
32,8,16,1,1,6,22,1179,75,1282
32,8,16,1,1,5,22,1176,77,1280
32,8,16,1,1,6,22,1176,80,1284
32,16,8,1,1,5,22,1236,75,1338
32,16,8,1,1,6,22,1237,81,1346
32,16,8,1,1,5,64,1236,73,1378
32,16,8,1,1,5,22,1236,86,1349
32,16,8,1,1,5,22,1240,76,1343
32,16,8,1,1,5,22,1236,81,1344
32,16,8,1,1,8,31,1241,173,1453
32,16,8,1,1,6,23,1237,81,1347
32,16,8,1,1,6,22,1237,77,1342
32,16,8,1,1,5,21,1238,75,1339
32,32,4,1,1,6,22,1367,77,1472
32,32,4,1,1,8,24,1396,148,1576
32,32,4,1,1,9,27,1371,103,1510
32,32,4,1,1,6,23,1367,78,1474
32,32,4,1,1,8,38,1381,146,1573
32,32,4,1,1,5,24,1368,88,1485
32,32,4,1,1,6,22,1367,82,1477
32,32,4,1,1,6,24,1368,89,1487
32,32,4,1,1,5,22,1366,74,1467
32,32,4,1,1,5,23,1366,74,1468
32,64,2,1,1,11,33,1369,81,1494
32,64,2,1,1,5,22,1365,84,1476
32,64,2,1,1,5,23,1364,79,1471
32,64,2,1,1,5,23,1369,78,1475
32,64,2,1,1,6,24,1366,94,1490
32,64,2,1,1,6,23,1365,79,1473
32,64,2,1,1,6,23,1365,80,1474
32,64,2,1,1,5,22,1364,82,1473
32,64,2,1,1,6,24,1366,83,1479
32,64,2,1,1,5,22,1364,78,1469
32,128,1,1,1,6,21,1363,77,1467
32,128,1,1,1,5,21,1363,75,1464
32,128,1,1,1,6,22,1363,104,1495
32,128,1,1,1,5,21,1362,74,1462
32,128,1,1,1,5,22,1364,79,1470
32,128,1,1,1,7,22,1363,77,1469
32,128,1,1,1,5,21,1363,75,1464
32,128,1,1,1,5,22,1363,104,1494
32,128,1,1,1,5,22,1362,80,1469
32,128,1,1,1,6,22,1363,77,1468
32,1,256,1,1,5,22,1128,80,1235
32,1,256,1,1,6,23,1128,76,1233
32,1,256,1,1,5,22,1127,73,1227
32,1,256,1,1,5,22,1131,73,1231
32,1,256,1,1,7,32,1150,271,1460
32,1,256,1,1,6,24,1130,114,1274
32,1,256,1,1,7,39,1143,115,1304
32,1,256,1,1,6,25,1131,120,1282
32,1,256,1,1,6,24,1127,97,1254
32,1,256,1,1,5,22,1127,75,1229
32,2,128,1,1,5,22,1145,80,1252
32,2,128,1,1,5,22,1145,75,1247
32,2,128,1,1,5,22,1145,74,1246
32,2,128,1,1,5,22,1145,76,1248
32,2,128,1,1,5,22,1145,74,1246
32,2,128,1,1,5,22,1144,76,1247
32,2,128,1,1,6,29,1153,82,1270
32,2,128,1,1,6,24,1147,94,1271
32,2,128,1,1,8,25,1147,110,1290
32,2,128,1,1,6,23,1146,90,1265
32,4,64,1,1,6,24,1166,93,1289
32,4,64,1,1,5,24,1180,123,1332
32,4,64,1,1,6,24,1162,90,1282
32,4,64,1,1,5,22,1165,78,1270
32,4,64,1,1,5,22,1163,78,1268
32,4,64,1,1,5,22,1162,76,1265
32,4,64,1,1,5,22,1163,76,1266
32,4,64,1,1,5,23,1161,76,1265
32,4,64,1,1,6,22,1162,79,1269
32,4,64,1,1,6,22,1162,74,1264
32,8,32,1,1,9,28,1201,88,1326
32,8,32,1,1,9,24,1198,170,1401
32,8,32,1,1,8,24,1196,111,1339
32,8,32,1,1,6,23,1195,103,1327
32,8,32,1,1,5,23,1196,91,1315
32,8,32,1,1,6,24,1196,95,1321
32,8,32,1,1,5,22,1194,78,1299
32,8,32,1,1,5,23,1195,80,1303
32,8,32,1,1,6,23,1195,80,1304
32,8,32,1,1,5,21,1195,76,1297
32,16,16,1,1,5,22,1261,75,1363
32,16,16,1,1,6,22,1261,78,1367
32,16,16,1,1,6,22,1261,115,1404
32,16,16,1,1,5,23,1261,79,1368
32,16,16,1,1,6,23,1263,122,1414
32,16,16,1,1,6,34,1265,121,1426
32,16,16,1,1,6,42,1263,96,1407
32,16,16,1,1,5,23,1262,90,1380
32,16,16,1,1,5,26,1261,120,1412
32,16,16,1,1,6,22,1260,78,1366
32,32,8,1,1,5,23,1416,85,1529
32,32,8,1,1,6,23,1415,80,1524
32,32,8,1,1,5,23,1415,77,1520
32,32,8,1,1,6,22,1416,77,1521
32,32,8,1,1,7,22,1414,76,1519
32,32,8,1,1,6,22,1415,82,1525
32,32,8,1,1,5,22,1415,86,1528
32,32,8,1,1,6,27,1418,88,1539
32,32,8,1,1,7,23,1416,87,1533
32,32,8,1,1,5,23,1415,81,1524
32,64,4,1,1,6,23,1380,102,1511
32,64,4,1,1,6,22,1379,89,1496
32,64,4,1,1,6,22,1385,239,1652
32,64,4,1,1,6,22,1385,98,1511
32,64,4,1,1,6,25,1381,99,1511
32,64,4,1,1,6,23,1385,130,1544
32,64,4,1,1,7,34,1384,127,1552
32,64,4,1,1,7,29,1384,114,1534
32,64,4,1,1,7,23,1380,95,1505
32,64,4,1,1,6,23,1380,83,1492
32,128,2,1,1,6,23,1370,88,1487
32,128,2,1,1,5,22,1369,80,1476
32,128,2,1,1,5,22,1370,76,1473
32,128,2,1,1,5,22,1370,74,1471
32,128,2,1,1,6,24,1373,162,1565
32,128,2,1,1,7,28,1374,121,1530
32,128,2,1,1,5,24,1370,81,1480
32,128,2,1,1,6,23,1370,76,1475
32,128,2,1,1,5,22,1369,75,1471
32,128,2,1,1,5,23,1369,74,1471
32,256,1,1,1,6,35,1362,74,1477
32,256,1,1,1,5,21,1362,74,1462
32,256,1,1,1,5,23,1362,77,1467
32,256,1,1,1,5,22,1362,74,1463
32,256,1,1,1,5,22,1363,75,1465
32,256,1,1,1,5,22,1362,95,1484
32,256,1,1,1,5,22,1362,76,1465
32,256,1,1,1,5,23,1364,136,1528
32,256,1,1,1,6,22,1364,105,1497
32,256,1,1,1,5,23,1363,90,1481
64,1,32,2,1,11,24,2432,82,2549
64,1,32,2,1,11,22,2431,78,2542
64,1,32,2,1,11,21,2433,76,2541
64,1,32,2,1,11,22,2427,79,2539
64,1,32,2,1,11,22,2443,180,2656
64,1,32,2,1,11,22,2436,124,2593
64,1,32,2,1,11,21,2432,74,2538
64,1,32,2,1,11,22,2430,74,2537
64,1,32,2,1,11,22,2427,89,2549
64,1,32,2,1,18,29,2455,145,2647
64,2,16,2,1,30,56,2442,234,2762
64,2,16,2,1,11,22,2430,117,2580
64,2,16,2,1,11,22,2438,79,2550
64,2,16,2,1,11,22,2426,75,2534
64,2,16,2,1,16,24,2433,113,2586
64,2,16,2,1,19,33,2445,210,2707
64,2,16,2,1,11,23,2433,81,2548
64,2,16,2,1,11,25,2435,152,2623
64,2,16,2,1,11,25,2436,131,2603
64,2,16,2,1,16,25,2435,88,2564
64,4,8,2,1,11,21,2431,76,2539
64,4,8,2,1,11,22,2435,80,2548
64,4,8,2,1,11,22,2434,140,2607
64,4,8,2,1,16,27,2436,133,2612
64,4,8,2,1,11,24,2433,85,2553
64,4,8,2,1,11,23,2436,125,2595
64,4,8,2,1,11,22,2436,171,2640
64,4,8,2,1,11,23,2434,141,2609
64,4,8,2,1,11,21,2430,82,2544
64,4,8,2,1,11,23,2445,82,2561
64,8,4,2,1,17,24,2431,84,2556
64,8,4,2,1,11,22,2432,128,2593
64,8,4,2,1,16,24,2434,143,2617
64,8,4,2,1,11,24,2440,151,2626
64,8,4,2,1,17,53,2448,131,2649
64,8,4,2,1,11,22,2435,100,2568
64,8,4,2,1,11,22,2435,83,2551
64,8,4,2,1,11,22,2432,81,2546
64,8,4,2,1,11,22,2435,80,2548
64,8,4,2,1,11,22,2432,74,2539
64,16,2,2,1,11,22,2432,76,2541
64,16,2,2,1,11,30,2443,142,2626
64,16,2,2,1,11,24,2430,83,2548
64,16,2,2,1,11,21,2432,75,2539
64,16,2,2,1,11,22,2431,86,2550
64,16,2,2,1,11,21,2432,152,2616
64,16,2,2,1,18,36,2438,145,2637
64,16,2,2,1,11,24,2428,81,2544
64,16,2,2,1,11,22,2433,76,2542
64,16,2,2,1,11,23,2430,102,2566
64,32,1,2,1,11,32,2451,135,2629
64,32,1,2,1,11,24,2449,81,2565
64,32,1,2,1,11,21,2444,83,2559
64,32,1,2,1,11,22,2444,76,2553
64,32,1,2,1,11,22,2446,140,2619
64,32,1,2,1,18,33,2448,138,2637
64,32,1,2,1,11,24,2447,123,2605
64,32,1,2,1,11,23,2452,154,2640
64,32,1,2,1,11,23,2445,115,2594
64,32,1,2,1,11,22,2445,80,2558
64,1,64,1,1,11,23,2215,77,2326
64,1,64,1,1,11,22,2216,79,2328
64,1,64,1,1,10,21,2226,78,2335
64,1,64,1,1,11,51,2226,139,2427
64,1,64,1,1,11,24,2216,86,2337
64,1,64,1,1,11,22,2216,84,2333
64,1,64,1,1,11,23,2216,76,2326
64,1,64,1,1,11,22,2215,85,2333
64,1,64,1,1,14,30,2223,138,2405
64,1,64,1,1,16,25,2217,109,2367
64,2,32,1,1,11,22,2233,83,2349
64,2,32,1,1,11,23,2233,77,2344
64,2,32,1,1,11,23,2235,80,2349
64,2,32,1,1,11,23,2239,166,2439
64,2,32,1,1,12,25,2237,133,2407
64,2,32,1,1,11,23,2236,102,2372
64,2,32,1,1,11,23,2234,79,2347
64,2,32,1,1,11,23,2233,87,2354
64,2,32,1,1,13,25,2238,183,2459
64,2,32,1,1,11,24,2236,97,2368
64,4,16,1,1,11,23,2250,117,2401
64,4,16,1,1,18,24,2256,87,2385
64,4,16,1,1,11,24,2250,83,2368
64,4,16,1,1,11,22,2249,79,2361
64,4,16,1,1,14,30,2248,82,2374
64,4,16,1,1,11,22,2248,91,2372
64,4,16,1,1,16,24,2249,91,2380
64,4,16,1,1,17,31,2257,146,2451
64,4,16,1,1,11,23,2249,108,2391
64,4,16,1,1,11,24,2253,84,2372
64,8,8,1,1,11,21,2278,79,2389
64,8,8,1,1,11,24,2279,88,2402
64,8,8,1,1,17,30,2288,146,2481
64,8,8,1,1,11,23,2285,107,2426
64,8,8,1,1,11,22,2279,75,2387
64,8,8,1,1,11,23,2278,77,2389
64,8,8,1,1,16,26,2283,160,2485
64,8,8,1,1,17,67,2303,181,2568
64,8,8,1,1,11,22,2292,400,2725
64,8,8,1,1,11,22,2278,81,2392
64,16,4,1,1,11,24,2339,84,2458
64,16,4,1,1,11,23,2339,80,2453
64,16,4,1,1,11,22,2341,78,2452
64,16,4,1,1,11,22,2340,76,2449
64,16,4,1,1,11,22,2338,76,2447
64,16,4,1,1,11,22,2341,171,2545
64,16,4,1,1,11,73,2347,128,2559
64,16,4,1,1,11,25,2342,87,2465
64,16,4,1,1,11,22,2340,79,2452
64,16,4,1,1,11,21,2341,123,2496
64,32,2,1,1,11,24,2465,131,2631
64,32,2,1,1,15,28,2466,114,2623
64,32,2,1,1,17,30,2473,225,2745
64,32,2,1,1,11,22,2463,98,2594
64,32,2,1,1,11,24,2470,147,2652
64,32,2,1,1,17,27,2466,123,2633
64,32,2,1,1,11,22,2462,80,2575
64,32,2,1,1,11,22,2467,226,2726
64,32,2,1,1,11,25,2465,134,2635
64,32,2,1,1,11,24,2463,92,2590
64,64,1,1,1,19,57,2461,166,2703
64,64,1,1,1,11,23,2445,127,2606
64,64,1,1,1,11,23,2443,88,2565
64,64,1,1,1,16,24,2444,101,2585
64,64,1,1,1,11,22,2442,76,2551
64,64,1,1,1,11,23,2443,88,2565
64,64,1,1,1,11,23,2442,87,2563
64,64,1,1,1,11,23,2445,146,2625
64,64,1,1,1,18,47,2461,275,2801
64,64,1,1,1,11,23,2446,171,2651
64,1,128,1,1,11,26,2191,126,2354
64,1,128,1,1,12,25,2194,141,2372
64,1,128,1,1,17,29,2194,120,2360
64,1,128,1,1,11,24,2188,107,2330
64,1,128,1,1,12,23,2189,86,2310
64,1,128,1,1,16,22,2187,78,2303
64,1,128,1,1,11,22,2187,76,2296
64,1,128,1,1,11,23,2188,121,2343
64,1,128,1,1,11,23,2189,120,2343
64,1,128,1,1,16,24,2186,79,2305
64,2,64,1,1,11,21,2216,79,2327
64,2,64,1,1,16,26,2216,166,2424
64,2,64,1,1,11,23,2206,83,2323
64,2,64,1,1,11,22,2209,82,2324
64,2,64,1,1,11,23,2205,86,2325
64,2,64,1,1,11,22,2208,77,2318
64,2,64,1,1,17,33,2211,136,2397
64,2,64,1,1,12,28,2211,159,2410
64,2,64,1,1,16,56,2226,187,2485
64,2,64,1,1,11,22,2204,80,2317
64,4,32,1,1,16,24,2227,294,2561
64,4,32,1,1,11,24,2222,135,2392
64,4,32,1,1,11,22,2221,83,2337
64,4,32,1,1,11,23,2221,82,2337
64,4,32,1,1,11,22,2220,85,2338
64,4,32,1,1,11,22,2220,76,2329
64,4,32,1,1,11,23,2226,161,2421
64,4,32,1,1,19,29,2225,157,2430
64,4,32,1,1,11,23,2224,88,2346
64,4,32,1,1,11,24,2226,165,2426
64,8,16,1,1,11,22,2254,119,2406
64,8,16,1,1,11,22,2250,80,2363
64,8,16,1,1,11,21,2249,75,2356
64,8,16,1,1,11,21,2251,81,2364
64,8,16,1,1,11,24,2255,139,2429
64,8,16,1,1,11,21,2251,83,2366
64,8,16,1,1,11,22,2251,91,2375
64,8,16,1,1,13,32,2259,159,2463
64,8,16,1,1,11,25,2255,112,2403
64,8,16,1,1,15,22,2250,81,2368
64,16,8,1,1,11,21,2313,79,2424
64,16,8,1,1,11,22,2313,86,2432
64,16,8,1,1,11,23,2315,86,2435
64,16,8,1,1,11,22,2313,81,2427
64,16,8,1,1,11,22,2312,76,2421
64,16,8,1,1,11,22,2311,77,2421
64,16,8,1,1,11,22,2311,78,2422
64,16,8,1,1,17,25,2318,164,2524
64,16,8,1,1,11,25,2317,144,2497
64,16,8,1,1,11,23,2312,79,2425
64,32,4,1,1,11,22,2447,236,2716
64,32,4,1,1,17,25,2444,101,2587
64,32,4,1,1,11,22,2447,167,2647
64,32,4,1,1,16,24,2447,140,2627
64,32,4,1,1,12,23,2443,82,2560
64,32,4,1,1,11,21,2442,77,2551
64,32,4,1,1,11,22,2444,126,2603
64,32,4,1,1,12,26,2452,133,2623
64,32,4,1,1,11,22,2442,89,2564
64,32,4,1,1,11,22,2441,75,2549
64,64,2,1,1,18,31,2466,153,2668
64,64,2,1,1,17,24,2456,112,2609
64,64,2,1,1,11,22,2466,127,2626
64,64,2,1,1,11,22,2456,93,2582
64,64,2,1,1,16,25,2460,154,2655
64,64,2,1,1,17,24,2454,78,2573
64,64,2,1,1,11,20,2455,76,2562
64,64,2,1,1,11,22,2456,197,2686
64,64,2,1,1,13,27,2460,91,2591
64,64,2,1,1,11,22,2455,78,2566
64,128,1,1,1,11,22,2442,74,2549
64,128,1,1,1,11,23,2442,84,2560
64,128,1,1,1,11,27,2448,136,2622
64,128,1,1,1,11,24,2442,80,2557
64,128,1,1,1,11,22,2442,80,2555
64,128,1,1,1,11,22,2451,290,2774
64,128,1,1,1,12,25,2444,122,2603
64,128,1,1,1,11,22,2447,336,2816
64,128,1,1,1,11,31,2453,177,2672
64,128,1,1,1,11,23,2442,88,2564
64,1,256,1,1,11,22,2212,81,2326
64,1,256,1,1,11,22,2217,184,2434
64,1,256,1,1,11,24,2214,98,2347
64,1,256,1,1,11,22,2217,124,2374
64,1,256,1,1,11,23,2218,206,2458
64,1,256,1,1,16,24,2215,90,2345
64,1,256,1,1,11,22,2214,88,2335
64,1,256,1,1,11,23,2213,100,2347
64,1,256,1,1,11,25,2220,150,2406
64,1,256,1,1,11,24,2214,155,2404
64,2,128,1,1,11,22,2230,76,2339
64,2,128,1,1,11,21,2231,107,2370
64,2,128,1,1,14,24,2242,151,2431
64,2,128,1,1,13,31,2236,214,2494
64,2,128,1,1,18,32,2238,140,2428
64,2,128,1,1,11,22,2231,77,2341
64,2,128,1,1,11,22,2231,78,2342
64,2,128,1,1,11,22,2232,82,2347
64,2,128,1,1,11,32,2242,147,2432
64,2,128,1,1,11,23,2231,81,2346
64,4,64,1,1,11,22,2248,77,2358
64,4,64,1,1,11,22,2249,81,2363
64,4,64,1,1,11,22,2256,180,2469
64,4,64,1,1,11,23,2254,118,2406
64,4,64,1,1,11,23,2251,79,2364
64,4,64,1,1,11,23,2248,77,2359
64,4,64,1,1,11,22,2247,85,2365
64,4,64,1,1,11,23,2252,200,2486
64,4,64,1,1,11,22,2249,89,2371
64,4,64,1,1,17,24,2249,93,2383
64,8,32,1,1,32,30,2292,198,2552
64,8,32,1,1,17,25,2283,84,2409
64,8,32,1,1,11,23,2283,116,2433
64,8,32,1,1,11,22,2281,87,2401
64,8,32,1,1,11,21,2282,86,2400
64,8,32,1,1,11,23,2282,76,2392
64,8,32,1,1,11,23,2287,158,2479
64,8,32,1,1,16,25,2283,120,2444
64,8,32,1,1,11,23,2281,78,2393
64,8,32,1,1,11,22,2281,74,2388
64,16,16,1,1,11,23,2348,85,2467
64,16,16,1,1,11,23,2349,88,2471
64,16,16,1,1,11,25,2349,104,2489
64,16,16,1,1,12,23,2348,83,2466
64,16,16,1,1,11,34,2372,79,2496
64,16,16,1,1,11,40,2359,165,2575
64,16,16,1,1,11,24,2350,134,2519
64,16,16,1,1,11,22,2347,81,2461
64,16,16,1,1,11,22,2346,81,2460
64,16,16,1,1,12,26,2359,249,2646
64,32,8,1,1,18,47,2521,244,2830
64,32,8,1,1,12,26,2504,109,2651
64,32,8,1,1,12,24,2503,117,2656
64,32,8,1,1,11,25,2502,88,2626
64,32,8,1,1,11,22,2502,81,2616
64,32,8,1,1,11,21,2508,207,2747
64,32,8,1,1,17,24,2502,90,2633
64,32,8,1,1,11,23,2501,79,2614
64,32,8,1,1,11,30,2506,156,2703
64,32,8,1,1,11,23,2504,135,2673
64,64,4,1,1,11,24,2499,83,2617
64,64,4,1,1,11,21,2497,81,2610
64,64,4,1,1,17,28,2505,163,2713
64,64,4,1,1,11,22,2497,84,2614
64,64,4,1,1,11,22,2498,86,2617
64,64,4,1,1,11,63,2517,132,2723
64,64,4,1,1,11,23,2510,82,2626
64,64,4,1,1,17,29,2502,111,2659
64,64,4,1,1,11,22,2498,87,2618
64,64,4,1,1,11,23,2500,115,2649
64,128,2,1,1,11,24,2476,158,2669
64,128,2,1,1,15,26,2474,108,2623
64,128,2,1,1,11,23,2470,80,2584
64,128,2,1,1,11,22,2470,98,2601
64,128,2,1,1,17,27,2473,151,2668
64,128,2,1,1,11,23,2469,78,2581
64,128,2,1,1,11,22,2470,75,2578
64,128,2,1,1,11,22,2473,184,2690
64,128,2,1,1,11,24,2471,101,2607
64,128,2,1,1,11,22,2469,80,2582
64,256,1,1,1,11,22,2443,77,2553
64,256,1,1,1,11,24,2448,166,2649
64,256,1,1,1,11,23,2442,89,2565
64,256,1,1,1,11,21,2442,79,2553
64,256,1,1,1,11,22,2442,75,2550
64,256,1,1,1,11,22,2443,112,2588
64,256,1,1,1,11,25,2450,131,2617
64,256,1,1,1,11,23,2441,77,2552
64,256,1,1,1,11,20,2442,76,2549
64,256,1,1,1,11,32,2456,161,2660
128,1,32,2,2,21,24,4611,99,4755
128,1,32,2,2,22,23,4614,76,4735
128,1,32,2,2,23,24,4618,170,4835
128,1,32,2,2,22,22,4611,78,4733
128,1,32,2,2,22,22,4617,141,4802
128,1,32,2,2,21,23,4617,83,4744
128,1,32,2,2,22,22,4615,88,4747
128,1,32,2,2,31,41,4629,153,4854
128,1,32,2,2,22,24,4614,84,4744
128,1,32,2,2,50,24,4616,92,4782
128,2,16,2,2,22,25,4617,87,4751
128,2,16,2,2,22,24,4614,83,4743
128,2,16,2,2,22,24,4621,143,4810
128,2,16,2,2,33,34,4624,177,4868
128,2,16,2,2,72,39,4626,190,4927
128,2,16,2,2,27,36,4631,214,4908
128,2,16,2,2,29,23,4620,184,4856
128,2,16,2,2,22,25,4620,89,4756
128,2,16,2,2,29,23,4619,123,4794
128,2,16,2,2,22,23,4620,149,4814
128,4,8,2,2,22,25,4623,87,4757
128,4,8,2,2,22,23,4619,78,4742
128,4,8,2,2,22,22,4619,127,4790
128,4,8,2,2,22,25,4616,125,4788
128,4,8,2,2,22,22,4618,79,4741
128,4,8,2,2,22,22,4621,182,4847
128,4,8,2,2,22,23,4615,89,4749
128,4,8,2,2,21,22,4614,74,4731
128,4,8,2,2,21,24,4618,145,4808
128,4,8,2,2,21,23,4616,80,4740
128,8,4,2,2,21,23,4621,191,4856
128,8,4,2,2,22,24,4616,118,4780
128,8,4,2,2,21,23,4607,84,4735
128,8,4,2,2,21,22,4617,213,4873
128,8,4,2,2,21,23,4616,114,4774
128,8,4,2,2,22,23,4615,78,4738
128,8,4,2,2,21,23,4620,213,4877
128,8,4,2,2,22,25,4621,93,4761
128,8,4,2,2,22,23,4614,79,4738
128,8,4,2,2,22,23,4623,240,4908
128,16,2,2,2,21,25,4625,121,4792
128,16,2,2,2,21,23,4618,75,4737
128,16,2,2,2,32,25,4618,141,4816
128,16,2,2,2,21,24,4615,81,4741
128,16,2,2,2,22,23,4611,78,4734
128,16,2,2,2,22,23,4618,153,4816
128,16,2,2,2,28,26,4616,96,4766
128,16,2,2,2,22,23,4612,88,4745
128,16,2,2,2,32,29,4620,153,4834
128,16,2,2,2,22,23,4610,82,4737
128,32,1,2,2,32,24,4626,145,4827
128,32,1,2,2,25,24,4626,125,4800
128,32,1,2,2,21,22,4624,92,4759
128,32,1,2,2,26,42,4642,132,4842
128,32,1,2,2,22,23,4624,90,4759
128,32,1,2,2,22,22,4627,183,4854
128,32,1,2,2,21,26,4628,122,4797
128,32,1,2,2,21,22,4624,75,4742
128,32,1,2,2,21,23,4627,168,4839
128,32,1,2,2,61,64,4649,146,4920
128,1,64,2,1,21,24,4568,100,4713
128,1,64,2,1,22,23,4571,82,4698
128,1,64,2,1,21,22,4578,123,4744
128,1,64,2,1,22,24,4574,80,4700
128,1,64,2,1,21,22,4573,77,4693
128,1,64,2,1,21,23,4578,201,4823
128,1,64,2,1,21,24,4576,122,4743
128,1,64,2,1,22,24,4569,81,4696
128,1,64,2,1,21,23,4577,76,4697
128,1,64,2,1,22,22,4574,152,4770
128,2,32,2,1,22,23,4568,86,4699
128,2,32,2,1,21,22,4567,79,4689
128,2,32,2,1,21,23,4575,249,4868
128,2,32,2,1,22,23,4566,109,4720
128,2,32,2,1,22,24,4562,83,4691
128,2,32,2,1,21,23,4561,103,4708
128,2,32,2,1,21,27,4589,179,4816
128,2,32,2,1,22,23,4564,81,4690
128,2,32,2,1,21,22,4566,77,4686
128,2,32,2,1,22,29,4570,146,4767
128,4,16,2,1,21,23,4578,89,4711
128,4,16,2,1,21,22,4570,78,4691
128,4,16,2,1,21,23,4576,142,4762
128,4,16,2,1,21,23,4572,121,4737
128,4,16,2,1,32,24,4567,89,4712
128,4,16,2,1,22,23,4566,86,4697
128,4,16,2,1,21,23,4566,115,4725
128,4,16,2,1,21,22,4565,81,4689
128,4,16,2,1,21,22,4567,94,4704
128,4,16,2,1,22,22,4567,81,4692
128,8,8,2,1,22,24,4573,105,4724
128,8,8,2,1,22,23,4573,82,4700
128,8,8,2,1,22,23,4579,140,4764
128,8,8,2,1,32,24,4580,89,4725
128,8,8,2,1,21,22,4578,80,4701
128,8,8,2,1,22,23,4574,121,4740
128,8,8,2,1,33,24,4571,97,4725
128,8,8,2,1,33,24,4579,134,4770
128,8,8,2,1,22,23,4568,83,4696
128,8,8,2,1,22,22,4574,77,4695
128,16,4,2,1,22,22,4580,146,4770
128,16,4,2,1,22,32,4586,145,4785
128,16,4,2,1,21,23,4575,94,4713
128,16,4,2,1,21,23,4573,95,4712
128,16,4,2,1,21,22,4578,136,4757
128,16,4,2,1,21,24,4587,125,4757
128,16,4,2,1,21,23,4578,76,4698
128,16,4,2,1,22,22,4577,115,4736
128,16,4,2,1,31,35,4583,186,4835
128,16,4,2,1,21,21,4577,79,4698
128,32,2,2,1,21,23,4630,96,4770
128,32,2,2,1,21,24,4634,142,4821
128,32,2,2,1,21,24,4632,138,4815
128,32,2,2,1,22,22,4631,82,4757
128,32,2,2,1,21,23,4631,77,4752
128,32,2,2,1,21,24,4631,121,4797
128,32,2,2,1,21,24,4631,80,4756
128,32,2,2,1,21,23,4626,76,4746
128,32,2,2,1,21,23,4634,192,4870
128,32,2,2,1,32,26,4632,126,4816
128,64,1,2,1,21,23,4604,102,4750
128,64,1,2,1,22,23,4610,81,4736
128,64,1,2,1,21,22,4614,148,4805
128,64,1,2,1,22,24,4609,80,4735
128,64,1,2,1,22,22,4608,77,4729
128,64,1,2,1,21,22,4648,167,4858
128,64,1,2,1,22,22,4609,103,4756
128,64,1,2,1,52,28,4611,84,4775
128,64,1,2,1,21,22,4612,144,4799
128,64,1,2,1,21,24,4616,141,4802
128,1,128,1,1,21,23,4331,80,4455
128,1,128,1,1,22,22,4334,78,4456
128,1,128,1,1,23,27,4332,98,4480
128,1,128,1,1,21,23,4332,92,4468
128,1,128,1,1,21,22,4333,81,4457
128,1,128,1,1,21,24,4336,145,4526
128,1,128,1,1,21,24,4333,84,4462
128,1,128,1,1,22,23,4332,80,4457
128,1,128,1,1,21,23,4336,179,4559
128,1,128,1,1,21,24,4334,100,4479
128,2,64,1,1,21,22,4350,78,4471
128,2,64,1,1,21,23,4380,164,4588
128,2,64,1,1,21,27,4354,147,4549
128,2,64,1,1,22,23,4350,79,4474
128,2,64,1,1,29,29,4356,263,4677
128,2,64,1,1,22,23,4354,179,4578
128,2,64,1,1,22,23,4354,145,4544
128,2,64,1,1,21,23,4349,105,4498
128,2,64,1,1,21,22,4349,75,4467
128,2,64,1,1,22,22,4353,136,4533
128,4,32,1,1,21,22,4365,77,4485
128,4,32,1,1,22,23,4366,104,4515
128,4,32,1,1,21,22,4366,166,4575
128,4,32,1,1,22,25,4367,127,4541
128,4,32,1,1,22,25,4368,117,4532
128,4,32,1,1,22,22,4368,76,4488
128,4,32,1,1,21,22,4371,289,4703
128,4,32,1,1,32,25,4369,127,4553
128,4,32,1,1,21,22,4365,82,4490
128,4,32,1,1,22,23,4370,181,4596
128,8,16,1,1,22,27,4402,131,4582
128,8,16,1,1,21,22,4396,75,4514
128,8,16,1,1,22,23,4397,161,4603
128,8,16,1,1,22,29,4403,154,4608
128,8,16,1,1,21,23,4396,118,4558
128,8,16,1,1,21,22,4394,76,4513
128,8,16,1,1,22,23,4396,83,4524
128,8,16,1,1,90,44,4399,124,4657
128,8,16,1,1,22,24,4396,82,4524
128,8,16,1,1,21,23,4394,76,4514
128,16,8,1,1,32,27,4464,125,4648
128,16,8,1,1,21,23,4456,100,4600
128,16,8,1,1,21,23,4455,88,4587
128,16,8,1,1,22,28,4465,139,4654
128,16,8,1,1,21,23,4455,121,4620
128,16,8,1,1,21,23,4456,88,4588
128,16,8,1,1,22,24,4459,133,4638
128,16,8,1,1,22,23,4459,149,4653
128,16,8,1,1,22,27,4461,163,4673
128,16,8,1,1,22,23,4456,80,4581
128,32,4,1,1,22,23,4584,81,4710
128,32,4,1,1,22,24,4590,155,4791
128,32,4,1,1,22,24,4587,100,4733
128,32,4,1,1,21,23,4585,83,4712
128,32,4,1,1,22,24,4588,122,4756
128,32,4,1,1,22,23,4585,82,4712
128,32,4,1,1,21,22,4587,90,4720
128,32,4,1,1,22,24,4589,187,4822
128,32,4,1,1,21,24,4590,81,4716
128,32,4,1,1,21,22,4586,88,4717
128,64,2,1,1,22,26,4624,240,4912
128,64,2,1,1,32,25,4605,88,4750
128,64,2,1,1,21,22,4606,194,4843
128,64,2,1,1,26,32,4613,127,4798
128,64,2,1,1,21,23,4619,78,4741
128,64,2,1,1,21,23,4608,206,4858
128,64,2,1,1,22,26,4606,118,4772
128,64,2,1,1,21,22,4602,80,4725
128,64,2,1,1,22,23,4606,206,4857
128,64,2,1,1,21,23,4608,184,4836
128,128,1,1,1,22,23,4611,82,4738
128,128,1,1,1,21,21,4618,149,4809
128,128,1,1,1,21,24,4621,122,4788
128,128,1,1,1,21,23,4612,86,4742
128,128,1,1,1,21,22,4619,174,4836
128,128,1,1,1,67,58,4622,124,4871
128,128,1,1,1,32,24,4616,81,4753
128,128,1,1,1,22,23,4625,173,4843
128,128,1,1,1,22,28,4618,125,4793
128,128,1,1,1,21,25,4619,81,4746
128,1,256,1,1,31,24,4382,141,4578
128,1,256,1,1,32,24,4380,86,4522
128,1,256,1,1,22,23,4379,83,4507
128,1,256,1,1,22,27,4383,136,4568
128,1,256,1,1,22,25,4384,97,4528
128,1,256,1,1,21,22,4378,92,4513
128,1,256,1,1,22,33,4391,155,4601
128,1,256,1,1,21,24,4382,114,4541
128,1,256,1,1,22,23,4380,98,4523
128,1,256,1,1,25,27,4384,128,4564
128,2,128,1,1,21,22,4397,78,4518
128,2,128,1,1,22,22,4401,134,4579
128,2,128,1,1,22,24,4400,132,4578
128,2,128,1,1,21,24,4397,85,4527
128,2,128,1,1,22,22,4400,80,4524
128,2,128,1,1,22,27,4400,189,4638
128,2,128,1,1,21,24,4396,84,4525
128,2,128,1,1,22,23,4396,77,4518
128,2,128,1,1,22,23,4400,142,4587
128,2,128,1,1,32,25,4399,98,4554
128,4,64,1,1,22,23,4413,83,4541
128,4,64,1,1,22,23,4421,155,4621
128,4,64,1,1,22,24,4414,102,4562
128,4,64,1,1,22,23,4413,83,4541
128,4,64,1,1,22,23,4417,198,4660
128,4,64,1,1,21,21,4413,154,4609
128,4,64,1,1,22,22,4412,76,4532
128,4,64,1,1,23,33,4420,123,4599
128,4,64,1,1,22,25,4415,87,4549
128,4,64,1,1,21,23,4412,75,4531
128,8,32,1,1,22,23,4449,141,4635
128,8,32,1,1,22,23,4447,104,4596
128,8,32,1,1,22,23,4446,79,4570
128,8,32,1,1,22,23,4450,195,4690
128,8,32,1,1,24,34,4450,118,4626
128,8,32,1,1,21,22,4450,79,4572
128,8,32,1,1,21,22,4452,163,4658
128,8,32,1,1,21,23,4450,111,4605
128,8,32,1,1,21,22,4445,77,4565
128,8,32,1,1,22,22,4450,160,4654
128,16,16,1,1,33,26,4515,110,4684
128,16,16,1,1,22,23,4511,95,4651
128,16,16,1,1,22,23,4516,144,4705
128,16,16,1,1,22,25,4513,89,4649
128,16,16,1,1,22,23,4512,84,4641
128,16,16,1,1,22,33,4521,127,4703
128,16,16,1,1,32,24,4512,82,4650
128,16,16,1,1,22,22,4512,88,4644
128,16,16,1,1,22,25,4515,120,4682
128,16,16,1,1,28,28,4525,146,4727
128,32,8,1,1,23,24,4667,115,4829
128,32,8,1,1,22,23,4669,124,4838
128,32,8,1,1,22,23,4670,233,4948
128,32,8,1,1,21,24,4668,84,4797
128,32,8,1,1,22,22,4665,75,4784
128,32,8,1,1,22,25,4670,146,4863
128,32,8,1,1,21,23,4664,79,4787
128,32,8,1,1,22,23,4666,81,4792
128,32,8,1,1,22,30,4682,139,4873
128,32,8,1,1,21,23,4667,81,4792
128,64,4,1,1,21,22,4668,98,4809
128,64,4,1,1,22,23,4668,139,4852
128,64,4,1,1,22,24,4665,84,4795
128,64,4,1,1,21,22,4664,90,4797
128,64,4,1,1,22,28,4670,124,4844
128,64,4,1,1,22,23,4663,92,4800
128,64,4,1,1,22,25,4669,128,4844
128,64,4,1,1,22,23,4662,80,4787
128,64,4,1,1,22,23,4667,144,4856
128,64,4,1,1,22,24,4667,118,4831
128,128,2,1,1,22,23,4663,81,4789
128,128,2,1,1,22,23,4669,156,4870
128,128,2,1,1,22,24,4665,88,4799
128,128,2,1,1,22,23,4662,78,4785
128,128,2,1,1,21,22,4667,145,4855
128,128,2,1,1,21,23,4665,90,4799
128,128,2,1,1,22,22,4664,80,4788
128,128,2,1,1,21,22,4664,142,4849
128,128,2,1,1,33,24,4664,96,4817
128,128,2,1,1,22,23,4665,92,4802
128,256,1,1,1,22,23,4619,152,4816
128,256,1,1,1,21,23,4613,92,4749
128,256,1,1,1,21,22,4613,76,4732
128,256,1,1,1,45,77,4628,150,4900
128,256,1,1,1,21,23,4615,86,4745
128,256,1,1,1,21,22,4615,92,4750
128,256,1,1,1,30,32,4620,131,4813
128,256,1,1,1,22,23,4615,96,4756
128,256,1,1,1,22,23,4618,198,4861
128,256,1,1,1,21,25,4617,118,4781
256,1,32,2,4,42,23,9001,216,9282
256,1,32,2,4,44,26,8996,123,9189
256,1,32,2,4,42,22,8998,157,9219
256,1,32,2,4,44,23,8993,85,9145
256,1,32,2,4,44,36,9003,130,9213
256,1,32,2,4,43,23,8999,162,9227
256,1,32,2,4,42,24,8995,85,9146
256,1,32,2,4,42,22,8998,125,9187
256,1,32,2,4,42,22,8996,124,9184
256,1,32,2,4,64,27,8995,86,9172
256,2,16,2,4,42,22,9003,137,9204
256,2,16,2,4,62,25,8999,83,9169
256,2,16,2,4,65,26,9005,157,9253
256,2,16,2,4,73,38,9020,174,9305
256,2,16,2,4,76,38,9016,143,9273
256,2,16,2,4,42,22,9002,141,9207
256,2,16,2,4,44,23,9003,229,9299
256,2,16,2,4,44,29,9009,149,9231
256,2,16,2,4,44,24,9001,87,9156
256,2,16,2,4,43,23,9003,136,9205
256,4,8,2,4,42,22,8991,87,9142
256,4,8,2,4,43,54,9023,132,9252
256,4,8,2,4,44,23,8996,135,9198
256,4,8,2,4,42,25,8991,90,9148
256,4,8,2,4,42,23,8993,129,9187
256,4,8,2,4,43,23,8993,102,9161
256,4,8,2,4,64,32,9001,132,9229
256,4,8,2,4,42,23,8993,156,9214
256,4,8,2,4,42,23,8996,177,9238
256,4,8,2,4,59,27,8996,134,9216
256,8,4,2,4,44,23,9001,267,9335
256,8,4,2,4,43,23,10563,184,10813
256,8,4,2,4,43,23,10546,154,10766
256,8,4,2,4,43,24,8997,144,9208
256,8,4,2,4,57,41,8997,155,9250
256,8,4,2,4,44,24,8997,129,9194
256,8,4,2,4,46,25,8996,121,9188
256,8,4,2,4,51,38,10579,130,10798
256,8,4,2,4,52,31,8999,124,9206
256,8,4,2,4,46,26,10566,175,10813
256,16,2,2,4,45,27,10439,372,10883
256,16,2,2,4,43,23,10434,131,10631
256,16,2,2,4,43,23,11322,140,11528
256,16,2,2,4,44,24,10436,94,10598
256,16,2,2,4,44,24,11309,131,11508
256,16,2,2,4,43,23,11306,129,11501
256,16,2,2,4,43,23,11324,161,11551
256,16,2,2,4,43,24,9001,112,9180
256,16,2,2,4,42,22,11320,129,11513
256,16,2,2,4,42,23,11306,143,11514
256,32,1,2,4,42,23,8994,81,9140
256,32,1,2,4,43,25,9000,131,9199
256,32,1,2,4,43,22,8998,180,9243
256,32,1,2,4,64,27,8992,114,9197
256,32,1,2,4,42,22,8999,144,9207
256,32,1,2,4,52,30,9002,136,9220
256,32,1,2,4,50,36,8998,125,9209
256,32,1,2,4,42,22,10930,147,11141
256,32,1,2,4,42,22,8997,209,9270
256,32,1,2,4,43,23,8992,85,9143
256,1,64,2,2,70,29,8945,129,9173
256,1,64,2,2,43,23,8949,148,9163
256,1,64,2,2,42,25,8938,85,9090
256,1,64,2,2,42,23,8939,133,9137
256,1,64,2,2,42,23,8947,145,9157
256,1,64,2,2,44,24,8945,138,9151
256,1,64,2,2,43,23,8937,143,9146
256,1,64,2,2,42,24,8949,107,9122
256,1,64,2,2,42,23,8945,145,9155
256,1,64,2,2,43,22,8944,91,9100
256,2,32,2,2,43,23,8942,168,9176
256,2,32,2,2,42,22,8943,110,9117
256,2,32,2,2,102,25,8953,112,9192
256,2,32,2,2,43,23,8944,148,9158
256,2,32,2,2,43,24,8941,83,9091
256,2,32,2,2,44,23,8951,127,9145
256,2,32,2,2,42,23,8961,149,9175
256,2,32,2,2,42,24,8953,87,9106
256,2,32,2,2,43,23,8959,130,9155
256,2,32,2,2,43,23,8953,107,9126
256,4,16,2,2,64,26,8975,138,9203
256,4,16,2,2,54,24,8976,176,9230
256,4,16,2,2,66,25,8974,93,9158
256,4,16,2,2,43,23,8974,126,9166
256,4,16,2,2,43,22,8973,96,9134
256,4,16,2,2,65,28,8973,128,9194
256,4,16,2,2,44,35,8986,128,9193
256,4,16,2,2,43,22,8983,170,9218
256,4,16,2,2,43,23,8975,98,9139
256,4,16,2,2,42,22,8964,144,9172
256,8,8,2,2,43,24,8967,87,9121
256,8,8,2,2,42,23,8973,126,9164
256,8,8,2,2,42,54,8979,235,9310
256,8,8,2,2,44,45,8982,133,9204
256,8,8,2,2,43,23,8978,126,9170
256,8,8,2,2,64,25,8982,175,9246
256,8,8,2,2,43,23,8975,145,9186
256,8,8,2,2,42,25,8965,90,9122
256,8,8,2,2,42,23,8971,126,9162
256,8,8,2,2,43,23,8969,86,9121
256,16,4,2,2,42,24,8969,125,9160
256,16,4,2,2,46,23,8964,194,9227
256,16,4,2,2,43,23,8965,91,9122
256,16,4,2,2,43,25,8966,117,9151
256,16,4,2,2,47,25,8946,137,9155
256,16,4,2,2,44,23,8962,149,9178
256,16,4,2,2,43,24,9668,93,9828
256,16,4,2,2,43,23,8961,150,9177
256,16,4,2,2,42,23,8954,85,9104
256,16,4,2,2,42,22,8966,132,9162
256,32,2,2,2,42,23,9046,129,9240
256,32,2,2,2,61,25,9044,142,9272
256,32,2,2,2,44,23,9049,149,9265
256,32,2,2,2,44,24,9040,134,9242
256,32,2,2,2,42,22,9046,142,9252
256,32,2,2,2,42,22,9050,86,9200
256,32,2,2,2,42,23,9053,129,9247
256,32,2,2,2,43,23,9048,152,9266
256,32,2,2,2,44,25,9048,131,9248
256,32,2,2,2,44,26,9048,127,9245
256,64,1,2,2,42,23,8975,127,9167
256,64,1,2,2,43,24,8976,111,9154
256,64,1,2,2,42,22,8997,140,9201
256,64,1,2,2,42,24,8984,128,9178
256,64,1,2,2,42,22,9002,181,9247
256,64,1,2,2,43,82,8986,128,9239
256,64,1,2,2,44,25,8979,119,9167
256,64,1,2,2,42,23,8977,133,9175
256,64,1,2,2,43,23,8988,111,9165
256,64,1,2,2,43,23,8980,150,9196
256,1,128,2,1,44,27,8857,103,9031
256,1,128,2,1,56,23,8857,132,9068
256,1,128,2,1,42,23,8857,78,9000
256,1,128,2,1,42,26,8853,118,9039
256,1,128,2,1,42,23,8857,167,9089
256,1,128,2,1,42,23,8858,86,9009
256,1,128,2,1,43,23,8862,128,9056
256,1,128,2,1,43,24,8852,138,9057
256,1,128,2,1,43,29,8850,129,9051
256,1,128,2,1,43,23,8856,168,9090
256,2,64,2,1,43,24,8856,134,9057
256,2,64,2,1,42,22,8850,164,9078
256,2,64,2,1,43,26,8858,122,9049
256,2,64,2,1,43,22,8852,151,9068
256,2,64,2,1,44,25,8852,118,9039
256,2,64,2,1,44,23,8868,142,9077
256,2,64,2,1,65,26,8854,90,9035
256,2,64,2,1,42,22,8858,128,9050
256,2,64,2,1,42,22,8861,146,9071
256,2,64,2,1,43,26,8856,115,9040
256,4,32,2,1,42,23,8863,144,9072
256,4,32,2,1,43,25,10538,126,10732
256,4,32,2,1,43,23,8848,132,9046
256,4,32,2,1,42,22,12526,168,12758
256,4,32,2,1,43,39,8865,125,9072
256,4,32,2,1,42,23,10528,129,10722
256,4,32,2,1,64,26,9896,104,10090
256,4,32,2,1,42,22,11492,125,11681
256,4,32,2,1,43,23,8848,154,9068
256,4,32,2,1,44,25,12093,122,12284
256,8,16,2,1,42,23,12128,123,12316
256,8,16,2,1,42,22,12021,140,12225
256,8,16,2,1,42,22,8840,83,8987
256,8,16,2,1,64,24,12269,100,12457
256,8,16,2,1,52,29,8843,97,9021
256,8,16,2,1,43,23,9057,126,9249
256,8,16,2,1,44,25,11988,110,12167
256,8,16,2,1,58,23,12733,128,12942
256,8,16,2,1,43,24,8855,140,9062
256,8,16,2,1,78,29,10633,130,10870
256,16,8,2,1,43,23,8853,115,9034
256,16,8,2,1,44,28,8861,114,9047
256,16,8,2,1,42,23,10306,168,10539
256,16,8,2,1,42,25,8845,82,8994
256,16,8,2,1,42,23,8858,130,9053
256,16,8,2,1,43,24,8848,126,9041
256,16,8,2,1,43,23,8855,138,9059
256,16,8,2,1,43,33,10303,130,10509
256,16,8,2,1,44,23,8862,149,9078
256,16,8,2,1,43,27,8845,125,9040
256,32,4,2,1,42,22,8885,140,9089
256,32,4,2,1,43,26,8885,115,9069
256,32,4,2,1,42,23,8888,203,9156
256,32,4,2,1,42,24,8882,105,9053
256,32,4,2,1,43,23,8884,128,9078
256,32,4,2,1,42,22,8883,78,9025
256,32,4,2,1,42,23,8886,128,9079
256,32,4,2,1,42,23,8882,99,9046
256,32,4,2,1,43,26,8889,127,9085
256,32,4,2,1,43,24,8889,188,9144
256,64,2,2,1,44,26,8906,126,9102
256,64,2,2,1,43,23,8907,183,9156
256,64,2,2,1,43,38,8915,124,9120
256,64,2,2,1,42,23,8902,132,9099
256,64,2,2,1,43,23,8901,90,9057
256,64,2,2,1,44,23,9764,129,9960
256,64,2,2,1,43,22,8905,111,9081
256,64,2,2,1,43,24,10258,126,10451
256,64,2,2,1,43,23,10461,142,10669
256,64,2,2,1,43,25,8901,86,9055
256,128,1,2,1,107,32,8930,114,9183
256,128,1,2,1,68,26,8926,126,9146
256,128,1,2,1,43,23,8930,170,9166
256,128,1,2,1,68,32,8928,136,9164
256,128,1,2,1,42,23,8923,144,9132
256,128,1,2,1,43,26,8926,88,9083
256,128,1,2,1,59,22,8924,136,9141
256,128,1,2,1,42,22,8921,86,9071
256,128,1,2,1,44,24,8923,131,9122
256,128,1,2,1,42,23,8924,215,9204
256,1,256,1,1,43,23,8716,116,8898
256,1,256,1,1,43,29,8715,130,8917
256,1,256,1,1,53,23,8715,121,8912
256,1,256,1,1,43,27,8719,123,8912
256,1,256,1,1,49,63,8718,137,8967
256,1,256,1,1,42,23,8713,82,8860
256,1,256,1,1,44,25,8716,130,8915
256,1,256,1,1,42,23,8717,191,8973
256,1,256,1,1,70,32,8718,131,8951
256,1,256,1,1,44,25,8719,133,8921
256,2,128,1,1,44,23,8736,155,8958
256,2,128,1,1,43,23,8737,201,9004
256,2,128,1,1,43,24,8738,141,8946
256,2,128,1,1,44,23,8734,161,8962
256,2,128,1,1,43,23,8730,88,8884
256,2,128,1,1,48,27,8734,122,8931
256,2,128,1,1,42,22,8732,134,8930
256,2,128,1,1,42,24,8729,86,8881
256,2,128,1,1,54,29,8734,128,8945
256,2,128,1,1,42,23,8741,216,9022
256,4,64,1,1,72,27,8748,96,8943
256,4,64,1,1,43,23,8753,161,8980
256,4,64,1,1,42,22,8752,262,9078
256,4,64,1,1,43,27,8770,122,8962
256,4,64,1,1,42,22,8750,133,8947
256,4,64,1,1,42,24,8752,121,8939
256,4,64,1,1,43,25,8755,134,8957
256,4,64,1,1,42,23,8752,174,8991
256,4,64,1,1,43,24,8753,110,8930
256,4,64,1,1,44,23,8753,130,8950
256,8,32,1,1,42,23,8785,94,8944
256,8,32,1,1,42,24,8785,132,8983
256,8,32,1,1,42,23,8786,146,8997
256,8,32,1,1,43,24,8784,84,8935
256,8,32,1,1,43,22,8786,139,8990
256,8,32,1,1,42,22,8781,100,8945
256,8,32,1,1,42,23,8786,102,8953
256,8,32,1,1,44,23,8786,132,8985
256,8,32,1,1,42,22,8789,116,8969
256,8,32,1,1,44,26,8786,126,8982
256,16,16,1,1,42,22,8852,137,9053
256,16,16,1,1,43,23,8852,178,9096
256,16,16,1,1,44,28,8854,132,9058
256,16,16,1,1,67,24,8853,163,9107
256,16,16,1,1,43,23,8848,87,9001
256,16,16,1,1,66,24,8851,128,9069
256,16,16,1,1,43,24,8848,86,9001
256,16,16,1,1,43,23,8851,132,9049
256,16,16,1,1,42,22,8854,289,9207
256,16,16,1,1,43,24,8848,91,9006
256,32,8,1,1,43,23,9006,142,9214
256,32,8,1,1,44,24,9005,109,9182
256,32,8,1,1,43,23,9007,147,9220
256,32,8,1,1,42,23,9003,128,9196
256,32,8,1,1,42,23,9003,113,9181
256,32,8,1,1,63,35,9009,136,9243
256,32,8,1,1,43,22,9003,142,9210
256,32,8,1,1,43,25,9002,122,9192
256,32,8,1,1,42,22,9004,154,9222
256,32,8,1,1,42,24,9004,88,9158
256,64,4,1,1,43,23,9005,131,9202
256,64,4,1,1,44,24,9005,159,9232
256,64,4,1,1,44,25,9006,160,9235
256,64,4,1,1,43,23,9008,160,9234
256,64,4,1,1,42,25,9007,85,9159
256,64,4,1,1,43,22,9004,128,9197
256,64,4,1,1,42,23,9004,111,9180
256,64,4,1,1,44,24,9004,118,9190
256,64,4,1,1,57,29,9008,178,9272
256,64,4,1,1,47,24,9003,83,9157
256,128,2,1,1,42,23,9006,129,9200
256,128,2,1,1,44,23,9007,168,9242
256,128,2,1,1,43,26,9015,128,9212
256,128,2,1,1,51,30,9010,135,9226
256,128,2,1,1,42,23,9006,201,9272
256,128,2,1,1,44,25,9004,92,9165
256,128,2,1,1,42,22,9023,145,9232
256,128,2,1,1,43,23,9006,188,9260
256,128,2,1,1,49,29,9008,129,9215
256,128,2,1,1,42,23,9007,142,9214
256,256,1,1,1,42,25,9018,100,9185
256,256,1,1,1,44,27,9028,130,9229
256,256,1,1,1,42,23,9019,163,9247
256,256,1,1,1,47,23,9018,86,9174
256,256,1,1,1,42,23,9019,131,9215
256,256,1,1,1,43,23,9017,83,9166
256,256,1,1,1,54,27,9019,104,9204
256,256,1,1,1,43,23,9019,150,9235
256,256,1,1,1,43,24,9019,156,9242
256,256,1,1,1,44,25,9020,126,9215
512,1,32,4,4,87,23,25753,143,26006
512,1,32,4,4,123,25,25028,127,25303
512,1,32,4,4,99,28,25764,129,26020
512,1,32,4,4,87,24,25014,142,25267
512,1,32,4,4,97,25,25759,134,26015
512,1,32,4,4,87,24,25743,170,26024
512,1,32,4,4,87,25,25754,156,26022
512,1,32,4,4,87,24,25740,142,25993
512,1,32,4,4,87,25,25733,163,26008
512,1,32,4,4,89,24,25749,267,26129
512,2,16,4,4,88,40,24836,133,25097
512,2,16,4,4,157,35,24900,194,25286
512,2,16,4,4,151,38,25299,180,25668
512,2,16,4,4,97,33,24682,133,24945
512,2,16,4,4,87,24,26400,182,26693
512,2,16,4,4,109,23,26397,140,26669
512,2,16,4,4,151,28,24834,176,25189
512,2,16,4,4,125,25,24683,141,24974
512,2,16,4,4,107,25,24830,137,25099
512,2,16,4,4,84,24,24831,141,25080
512,4,8,4,4,127,33,23585,130,23875
512,4,8,4,4,84,23,23530,133,23770
512,4,8,4,4,103,27,24461,135,24726
512,4,8,4,4,87,24,24554,206,24871
512,4,8,4,4,102,29,23593,140,23864
512,4,8,4,4,87,25,24470,132,24714
512,4,8,4,4,84,23,23583,151,23841
512,4,8,4,4,85,26,23584,128,23823
512,4,8,4,4,87,24,23530,179,23820
512,4,8,4,4,85,25,23582,130,23822
512,8,4,4,4,107,25,24424,162,24718
512,8,4,4,4,92,28,24513,174,24807
512,8,4,4,4,84,23,24514,142,24763
512,8,4,4,4,87,24,24439,131,24681
512,8,4,4,4,84,24,25830,152,26090
512,8,4,4,4,87,25,24721,137,24970
512,8,4,4,4,87,26,25831,136,26080
512,8,4,4,4,87,24,24536,151,24798
512,8,4,4,4,85,25,24430,133,24673
512,8,4,4,4,84,24,25829,147,26084
512,16,2,4,4,84,24,25777,135,26020
512,16,2,4,4,111,39,25805,142,26097
512,16,2,4,4,87,23,25805,146,26061
512,16,2,4,4,173,25,27078,129,27405
512,16,2,4,4,84,23,27084,144,27335
512,16,2,4,4,84,24,26343,128,26579
512,16,2,4,4,85,23,26803,138,27049
512,16,2,4,4,84,24,25786,140,26034
512,16,2,4,4,95,30,25789,132,26046
512,16,2,4,4,84,23,26304,147,26558
512,32,1,4,4,87,25,24834,229,25175
512,32,1,4,4,154,34,24260,155,24603
512,32,1,4,4,84,24,24689,145,24942
512,32,1,4,4,85,24,24652,133,24894
512,32,1,4,4,122,24,24673,153,24972
512,32,1,4,4,85,26,24654,126,24891
512,32,1,4,4,85,23,24315,153,24576
512,32,1,4,4,165,27,24837,131,25160
512,32,1,4,4,85,24,24657,155,24921
512,32,1,4,4,84,24,24718,134,24960
512,1,64,2,4,87,24,17723,132,17966
512,1,64,2,4,84,22,17698,130,17934
512,1,64,2,4,85,24,20321,161,20591
512,1,64,2,4,85,24,17689,152,17950
512,1,64,2,4,84,24,20295,132,20535
512,1,64,2,4,87,24,17712,133,17956
512,1,64,2,4,85,22,17727,132,17966
512,1,64,2,4,85,24,17692,129,17930
512,1,64,2,4,84,23,17699,129,17935
512,1,64,2,4,84,24,17702,133,17943
512,2,32,2,4,85,25,17718,223,18051
512,2,32,2,4,85,28,17729,217,18059
512,2,32,2,4,108,31,17725,178,18042
512,2,32,2,4,125,27,17721,172,18045
512,2,32,2,4,84,24,17730,141,17979
512,2,32,2,4,87,27,17710,146,17970
512,2,32,2,4,96,24,17717,157,17994
512,2,32,2,4,85,27,17712,155,17979
512,2,32,2,4,95,28,17703,143,17969
512,2,32,2,4,85,23,17702,133,17943
512,4,16,2,4,84,24,17734,232,18074
512,4,16,2,4,84,23,17753,132,17992
512,4,16,2,4,87,24,17748,132,17991
512,4,16,2,4,118,37,17752,132,18039
512,4,16,2,4,85,23,17751,223,18082
512,4,16,2,4,128,28,17743,144,18043
512,4,16,2,4,92,37,17752,222,18103
512,4,16,2,4,126,26,17750,151,18053
512,4,16,2,4,88,25,17750,140,18003
512,4,16,2,4,87,24,17759,128,17998
512,8,8,2,4,88,23,17772,132,18015
512,8,8,2,4,84,24,25166,148,25422
512,8,8,2,4,125,24,20201,129,20479
512,8,8,2,4,85,23,23015,330,23453
512,8,8,2,4,87,25,17778,147,18037
512,8,8,2,4,84,24,20708,185,21001
512,8,8,2,4,87,25,17783,127,18022
512,8,8,2,4,87,24,19188,171,19470
512,8,8,2,4,85,35,22752,131,23003
512,8,8,2,4,87,24,17778,134,18023
512,16,4,2,4,87,24,25498,188,25797
512,16,4,2,4,100,29,23819,133,24081
512,16,4,2,4,85,23,25307,143,25558
512,16,4,2,4,84,25,25462,132,25703
512,16,4,2,4,85,24,24685,138,24932
512,16,4,2,4,84,25,20309,132,20550
512,16,4,2,4,84,24,23914,180,24202
512,16,4,2,4,85,26,25458,133,25702
512,16,4,2,4,87,24,23787,175,24073
512,16,4,2,4,127,27,23736,130,24020
512,32,2,2,4,84,23,17902,131,18140
512,32,2,2,4,84,24,24150,141,24399
512,32,2,2,4,85,25,23342,136,23588
512,32,2,2,4,87,24,24994,139,25244
512,32,2,2,4,84,23,17924,135,18166
512,32,2,2,4,87,24,17917,133,18161
512,32,2,2,4,85,24,23235,195,23539
512,32,2,2,4,85,26,23687,131,23929
512,32,2,2,4,87,24,24960,173,25244
512,32,2,2,4,122,25,23257,142,23546
512,64,1,2,4,129,28,23340,135,23632
512,64,1,2,4,84,24,23551,145,23804
512,64,1,2,4,85,25,24036,172,24318
512,64,1,2,4,87,23,24197,144,24451
512,64,1,2,4,85,25,24020,139,24269
512,64,1,2,4,85,23,22871,163,23142
512,64,1,2,4,87,26,23202,134,23449
512,64,1,2,4,85,23,23208,144,23460
512,64,1,2,4,90,26,23173,140,23429
512,64,1,2,4,85,22,24036,150,24293
512,1,128,2,2,85,25,17472,155,17737
512,1,128,2,2,85,26,17466,148,17725
512,1,128,2,2,122,25,17492,133,17772
512,1,128,2,2,87,25,17484,136,17732
512,1,128,2,2,87,22,17467,136,17712
512,1,128,2,2,87,24,17491,129,17731
512,1,128,2,2,88,35,17475,157,17755
512,1,128,2,2,132,31,17466,138,17767
512,1,128,2,2,87,25,17481,131,17724
512,1,128,2,2,85,25,17482,133,17725
512,2,64,2,2,127,25,17467,132,17751
512,2,64,2,2,84,23,17474,134,17715
512,2,64,2,2,87,24,17491,129,17731
512,2,64,2,2,84,24,17485,132,17725
512,2,64,2,2,87,22,17485,140,17734
512,2,64,2,2,128,27,17473,160,17788
512,2,64,2,2,89,26,17486,151,17752
512,2,64,2,2,87,26,17484,153,17750
512,2,64,2,2,93,27,17491,129,17740
512,2,64,2,2,85,24,17481,129,17719
512,4,32,2,2,84,24,17465,131,17704
512,4,32,2,2,87,23,17477,129,17716
512,4,32,2,2,87,24,17474,134,17719
512,4,32,2,2,88,26,17479,166,17759
512,4,32,2,2,85,29,17476,138,17728
512,4,32,2,2,87,25,17468,153,17733
512,4,32,2,2,125,24,17472,132,17753
512,4,32,2,2,85,35,17464,138,17722
512,4,32,2,2,128,25,17477,131,17761
512,4,32,2,2,84,23,17467,130,17704
512,8,16,2,2,84,24,17471,142,17721
512,8,16,2,2,168,69,20157,148,20542
512,8,16,2,2,84,26,17466,129,17705
512,8,16,2,2,128,25,25372,173,25698
512,8,16,2,2,103,24,17469,163,17759
512,8,16,2,2,87,25,20163,133,20408
512,8,16,2,2,126,25,18090,138,18379
512,8,16,2,2,84,25,20696,134,20939
512,8,16,2,2,85,23,23159,194,23461
512,8,16,2,2,140,28,23180,140,23488
512,16,8,2,2,85,24,17489,135,17733
512,16,8,2,2,87,24,17490,133,17734
512,16,8,2,2,87,25,17494,146,17752
512,16,8,2,2,87,25,17492,237,17841
512,16,8,2,2,85,42,17501,157,17785
512,16,8,2,2,85,25,17490,151,17751
512,16,8,2,2,112,30,17493,147,17782
512,16,8,2,2,88,30,17499,207,17824
512,16,8,2,2,87,28,17496,141,17752
512,16,8,2,2,87,25,17493,161,17766
512,32,4,2,2,137,25,17613,130,17905
512,32,4,2,2,87,23,17614,136,17860
512,32,4,2,2,84,23,17614,131,17852
512,32,4,2,2,84,24,17615,130,17853
512,32,4,2,2,84,23,17616,192,17915
512,32,4,2,2,87,24,17615,144,17870
512,32,4,2,2,147,84,17661,136,18028
512,32,4,2,2,87,24,17617,148,17876
512,32,4,2,2,130,25,17617,130,17902
512,32,4,2,2,87,24,17616,133,17860
512,64,2,2,2,84,24,17637,133,17878
512,64,2,2,2,113,24,17641,130,17908
512,64,2,2,2,84,24,17638,124,17870
512,64,2,2,2,97,30,17648,179,17954
512,64,2,2,2,135,35,17641,200,18011
512,64,2,2,2,131,27,17634,151,17943
512,64,2,2,2,105,30,17638,133,17906
512,64,2,2,2,84,24,17634,128,17870
512,64,2,2,2,87,24,17635,130,17876
512,64,2,2,2,84,23,17672,130,17909
512,128,1,2,2,87,25,17633,129,17874
512,128,1,2,2,106,26,17630,168,17930
512,128,1,2,2,120,28,17636,194,17978
512,128,1,2,2,85,24,17637,161,17907
512,128,1,2,2,87,24,17632,144,17887
512,128,1,2,2,84,24,17633,132,17873
512,128,1,2,2,85,24,17635,133,17877
512,128,1,2,2,84,23,17639,134,17880
512,128,1,2,2,84,22,17635,131,17872
512,128,1,2,2,87,24,17640,136,17887
512,1,256,2,1,101,39,17571,196,17907
512,1,256,2,1,87,26,17555,139,17807
512,1,256,2,1,112,41,17559,146,17858
512,1,256,2,1,87,26,17558,129,17800
512,1,256,2,1,84,23,17566,131,17804
512,1,256,2,1,99,25,17548,131,17803
512,1,256,2,1,84,24,17548,129,17785
512,1,256,2,1,88,32,17549,232,17901
512,1,256,2,1,87,26,17551,142,17806
512,1,256,2,1,136,33,17565,139,17873
512,2,128,2,1,85,27,17536,154,17802
512,2,128,2,1,125,25,17552,133,17835
512,2,128,2,1,84,24,17543,129,17780
512,2,128,2,1,84,24,21409,148,21665
512,2,128,2,1,150,34,17547,154,17885
512,2,128,2,1,130,30,17542,154,17856
512,2,128,2,1,87,26,17541,146,17800
512,2,128,2,1,87,25,17533,133,17778
512,2,128,2,1,84,23,17540,134,17781
512,2,128,2,1,127,25,17535,131,17818
512,4,64,2,1,87,25,17538,132,17782
512,4,64,2,1,85,24,17539,132,17780
512,4,64,2,1,87,24,17536,128,17775
512,4,64,2,1,86,32,17534,192,17844
512,4,64,2,1,87,26,17549,146,17808
512,4,64,2,1,84,22,17537,131,17774
512,4,64,2,1,87,24,19382,133,19626
512,4,64,2,1,85,22,17528,130,17765
512,4,64,2,1,85,23,21071,333,21512
512,4,64,2,1,127,28,21073,127,21355
512,8,32,2,1,85,25,20662,130,20902
512,8,32,2,1,85,25,23371,126,23607
512,8,32,2,1,84,24,24628,139,24875
512,8,32,2,1,87,25,24600,134,24846
512,8,32,2,1,123,23,23183,148,23477
512,8,32,2,1,87,25,23533,133,23778
512,8,32,2,1,85,23,20618,262,20988
512,8,32,2,1,85,28,20641,133,20887
512,8,32,2,1,87,24,23494,131,23736
512,8,32,2,1,84,23,24412,182,24701
512,16,16,2,1,84,23,17533,137,17777
512,16,16,2,1,85,23,17535,126,17769
512,16,16,2,1,128,26,17537,142,17833
512,16,16,2,1,87,24,17538,131,17780
512,16,16,2,1,87,24,17539,134,17784
512,16,16,2,1,85,23,17556,136,17800
512,16,16,2,1,85,25,22303,151,22564
512,16,16,2,1,84,24,17541,130,17779
512,16,16,2,1,84,22,17544,132,17782
512,16,16,2,1,150,50,17554,245,17999
512,32,8,2,1,131,27,17645,148,17951
512,32,8,2,1,85,24,17646,145,17900
512,32,8,2,1,87,24,17648,134,17893
512,32,8,2,1,84,23,17645,133,17885
512,32,8,2,1,87,24,17654,148,17913
512,32,8,2,1,87,25,17650,132,17894
512,32,8,2,1,85,24,17652,132,17893
512,32,8,2,1,87,24,17647,130,17888
512,32,8,2,1,85,24,17646,147,17902
512,32,8,2,1,128,34,17658,151,17971
512,64,4,2,1,130,27,17652,147,17956
512,64,4,2,1,87,24,17657,135,17903
512,64,4,2,1,87,24,17653,132,17896
512,64,4,2,1,87,24,17654,158,17923
512,64,4,2,1,85,28,17678,179,17970
512,64,4,2,1,87,25,17653,134,17899
512,64,4,2,1,98,31,17650,127,17906
512,64,4,2,1,84,24,17651,169,17928
512,64,4,2,1,87,24,17651,134,17896
512,64,4,2,1,85,23,17651,133,17892
512,128,2,2,1,85,24,17651,129,17889
512,128,2,2,1,85,30,17666,147,17928
512,128,2,2,1,85,24,17659,151,17919
512,128,2,2,1,85,26,17650,132,17893
512,128,2,2,1,85,24,17648,130,17887
512,128,2,2,1,84,23,17656,130,17893
512,128,2,2,1,84,23,17652,131,17890
512,128,2,2,1,127,24,17654,130,17935
512,128,2,2,1,84,24,17652,132,17892
512,128,2,2,1,85,23,17650,144,17902
512,256,1,2,1,85,24,17683,130,17922
512,256,1,2,1,127,24,17678,130,17959
512,256,1,2,1,85,23,17679,170,17957
512,256,1,2,1,85,23,17675,134,17917
512,256,1,2,1,87,24,17674,124,17909
512,256,1,2,1,84,24,17676,139,17923
512,256,1,2,1,85,23,17678,145,17931
512,256,1,2,1,163,25,17677,147,18012
512,256,1,2,1,129,25,17674,151,17979
512,256,1,2,1,84,23,17680,130,17917
1024,1,32,4,8,169,26,51517,137,51849
1024,1,32,4,8,169,26,50243,156,50594
1024,1,32,4,8,173,27,47915,155,48270
1024,1,32,4,8,174,29,41133,139,41475
1024,1,32,4,8,173,26,40205,138,40542
1024,1,32,4,8,169,26,39708,144,40047
1024,1,32,4,8,169,27,41157,929,42282
1024,1,32,4,8,173,26,39948,172,40319
1024,1,32,4,8,169,26,40057,134,40386
1024,1,32,4,8,171,26,39968,205,40370
1024,2,16,4,8,310,38,39845,198,40391
1024,2,16,4,8,220,33,40327,183,40763
1024,2,16,4,8,259,45,39839,139,40282
1024,2,16,4,8,169,26,41067,135,41397
1024,2,16,4,8,169,26,41071,136,41402
1024,2,16,4,8,191,26,39719,254,40190
1024,2,16,4,8,261,29,41056,152,41498
1024,2,16,4,8,169,25,41341,136,41671
1024,2,16,4,8,174,27,40332,133,40666
1024,2,16,4,8,169,25,41067,165,41426
1024,4,8,4,8,175,27,40099,134,40435
1024,4,8,4,8,169,25,42651,193,43038
1024,4,8,4,8,169,28,38910,158,39265
1024,4,8,4,8,173,26,40963,137,41299
1024,4,8,4,8,176,32,40973,139,41320
1024,4,8,4,8,178,28,40812,137,41155
1024,4,8,4,8,177,26,39048,151,39402
1024,4,8,4,8,170,27,40982,136,41315
1024,4,8,4,8,169,25,40984,166,41344
1024,4,8,4,8,255,28,40978,135,41396
1024,8,4,4,8,255,38,39901,143,40337
1024,8,4,4,8,201,30,39893,143,40267
1024,8,4,4,8,176,62,39881,139,40258
1024,8,4,4,8,189,27,39886,142,40244
1024,8,4,4,8,174,26,39886,137,40223
1024,8,4,4,8,173,25,39883,150,40231
1024,8,4,4,8,173,26,39881,159,40239
1024,8,4,4,8,193,29,39863,161,40246
1024,8,4,4,8,174,30,39889,142,40235
1024,8,4,4,8,174,30,39884,136,40224
1024,16,2,4,8,173,26,40409,134,40742
1024,16,2,4,8,169,25,40201,164,40559
1024,16,2,4,8,169,26,38768,132,39095
1024,16,2,4,8,169,26,38445,135,38775
1024,16,2,4,8,169,26,40195,249,40639
1024,16,2,4,8,169,27,40417,133,40746
1024,16,2,4,8,169,25,40237,204,40635
1024,16,2,4,8,170,34,39024,137,39365
1024,16,2,4,8,179,26,40405,134,40744
1024,16,2,4,8,169,25,40726,154,41074
1024,32,1,4,8,169,26,38170,134,38499
1024,32,1,4,8,169,25,38255,267,38716
1024,32,1,4,8,170,28,38249,136,38583
1024,32,1,4,8,169,25,39123,137,39454
1024,32,1,4,8,169,25,38614,189,38997
1024,32,1,4,8,169,27,38449,136,38781
1024,32,1,4,8,169,25,38333,130,38657
1024,32,1,4,8,170,32,38693,133,39028
1024,32,1,4,8,169,25,38344,139,38677
1024,32,1,4,8,169,26,39369,169,39733
1024,1,64,4,4,169,27,37373,148,37717
1024,1,64,4,4,209,45,37315,134,37703
1024,1,64,4,4,214,25,37324,211,37774
1024,1,64,4,4,169,26,39310,227,39732
1024,1,64,4,4,173,26,36670,142,37011
1024,1,64,4,4,173,27,40170,161,40531
1024,1,64,4,4,169,27,39131,132,39459
1024,1,64,4,4,169,25,40786,186,41166
1024,1,64,4,4,243,32,39082,138,39495
1024,1,64,4,4,173,26,36125,166,36490
1024,2,32,4,4,173,26,36098,173,36470
1024,2,32,4,4,169,34,37238,149,37590
1024,2,32,4,4,260,28,39407,148,39843
1024,2,32,4,4,179,42,35526,152,35899
1024,2,32,4,4,174,28,35774,134,36110
1024,2,32,4,4,169,25,40830,192,41216
1024,2,32,4,4,169,28,37231,132,37560
1024,2,32,4,4,169,26,35512,143,35850
1024,2,32,4,4,169,25,35513,131,35838
1024,2,32,4,4,191,26,37058,141,37416
1024,4,16,4,4,188,31,36269,135,36623
1024,4,16,4,4,169,25,36252,132,36578
1024,4,16,4,4,169,25,38880,163,39237
1024,4,16,4,4,169,29,37104,130,37432
1024,4,16,4,4,169,25,36259,137,36590
1024,4,16,4,4,169,25,39338,194,39726
1024,4,16,4,4,225,36,38188,149,38598
1024,4,16,4,4,169,25,38369,142,38705
1024,4,16,4,4,170,28,39501,135,39834
1024,4,16,4,4,174,26,38659,331,39190
1024,8,8,4,4,177,28,39388,172,39765
1024,8,8,4,4,255,28,36246,143,36672
1024,8,8,4,4,173,26,36305,138,36642
1024,8,8,4,4,178,26,40624,148,40976
1024,8,8,4,4,224,27,38665,140,39056
1024,8,8,4,4,170,26,38912,220,39328
1024,8,8,4,4,174,28,36431,146,36779
1024,8,8,4,4,173,25,38969,135,39302
1024,8,8,4,4,173,25,38287,183,38668
1024,8,8,4,4,229,31,36256,151,36667
1024,16,4,4,4,170,27,36888,129,37214
1024,16,4,4,4,169,26,37063,133,37391
1024,16,4,4,4,248,34,38626,160,39068
1024,16,4,4,4,169,26,37669,136,38000
1024,16,4,4,4,169,26,36724,170,37089
1024,16,4,4,4,174,32,36628,143,36977
1024,16,4,4,4,169,25,37880,137,38211
1024,16,4,4,4,169,25,36371,159,36724
1024,16,4,4,4,253,30,39804,135,40222
1024,16,4,4,4,169,26,36529,134,36858
1024,32,2,4,4,169,25,39439,162,39795
1024,32,2,4,4,174,28,34715,153,35070
1024,32,2,4,4,169,27,39959,135,40290
1024,32,2,4,4,169,26,35344,136,35675
1024,32,2,4,4,170,28,36174,149,36521
1024,32,2,4,4,255,27,35965,132,36379
1024,32,2,4,4,169,26,39390,132,39717
1024,32,2,4,4,169,25,40312,136,40642
1024,32,2,4,4,169,26,36375,129,36699
1024,32,2,4,4,173,26,36469,132,36800
1024,64,1,4,4,169,26,34586,151,34932
1024,64,1,4,4,178,29,42417,132,42756
1024,64,1,4,4,173,26,39416,177,39792
1024,64,1,4,4,185,29,36277,152,36643
1024,64,1,4,4,169,25,42410,167,42771
1024,64,1,4,4,175,28,41064,135,41402
1024,64,1,4,4,169,26,39360,134,39689
1024,64,1,4,4,195,26,40360,137,40718
1024,64,1,4,4,228,32,35596,133,35989
1024,64,1,4,4,169,26,35286,130,35611
1024,1,128,2,4,257,27,28054,170,28508
1024,1,128,2,4,174,27,28781,140,29122
1024,1,128,2,4,169,25,29964,137,30295
1024,1,128,2,4,169,26,30107,151,30453
1024,1,128,2,4,169,26,29772,137,30104
1024,1,128,2,4,257,29,28493,293,29072
1024,1,128,2,4,174,30,28670,147,29021
1024,1,128,2,4,174,28,29137,136,29475
1024,1,128,2,4,169,25,30812,139,31145
1024,1,128,2,4,173,26,29753,136,30088
1024,2,64,2,4,173,27,28502,151,28853
1024,2,64,2,4,169,25,29059,146,29399
1024,2,64,2,4,173,27,30661,264,31125
1024,2,64,2,4,174,28,31528,163,31893
1024,2,64,2,4,169,27,31056,150,31402
1024,2,64,2,4,174,31,26862,134,27201
1024,2,64,2,4,169,25,31622,133,31949
1024,2,64,2,4,173,25,26859,133,27190
1024,2,64,2,4,208,26,29110,153,29497
1024,2,64,2,4,169,26,29050,175,29420
1024,4,32,2,4,169,28,27534,162,27893
1024,4,32,2,4,209,37,28932,209,29387
1024,4,32,2,4,254,29,32148,221,32652
1024,4,32,2,4,169,27,26854,132,27182
1024,4,32,2,4,173,26,29459,134,29792
1024,4,32,2,4,210,26,29807,137,30180
1024,4,32,2,4,169,26,36600,156,36951
1024,4,32,2,4,181,28,28017,132,28358
1024,4,32,2,4,169,25,29971,143,30308
1024,4,32,2,4,169,25,31241,142,31577
1024,8,16,2,4,192,28,31997,187,32404
1024,8,16,2,4,290,34,32192,181,32697
1024,8,16,2,4,184,47,33845,145,34221
1024,8,16,2,4,169,27,28218,134,28548
1024,8,16,2,4,170,26,31831,136,32163
1024,8,16,2,4,250,30,31634,132,32046
1024,8,16,2,4,169,26,37851,148,38194
1024,8,16,2,4,209,29,37839,137,38214
1024,8,16,2,4,169,26,37644,133,37972
1024,8,16,2,4,169,25,36351,137,36682
1024,16,8,2,4,169,25,37967,154,38315
1024,16,8,2,4,169,26,38668,135,38998
1024,16,8,2,4,169,25,36528,142,36864
1024,16,8,2,4,169,26,37762,183,38140
1024,16,8,2,4,174,27,36131,135,36467
1024,16,8,2,4,169,25,26871,157,27222
1024,16,8,2,4,169,29,30802,178,31178
1024,16,8,2,4,169,28,29700,169,30066
1024,16,8,2,4,171,37,29506,143,29857
1024,16,8,2,4,169,26,35120,133,35448
1024,32,4,2,4,173,25,33505,133,33836
1024,32,4,2,4,169,25,32049,134,32377
1024,32,4,2,4,169,26,30575,138,30908
1024,32,4,2,4,169,25,32634,133,32961
1024,32,4,2,4,169,26,30484,132,30811
1024,32,4,2,4,169,27,31249,138,31583
1024,32,4,2,4,169,27,32658,145,32999
1024,32,4,2,4,169,28,30961,160,31318
1024,32,4,2,4,169,84,30607,224,31084
1024,32,4,2,4,169,28,31688,289,32174
1024,64,2,2,4,173,28,34577,147,34925
1024,64,2,2,4,169,27,34099,152,34447
1024,64,2,2,4,169,35,34555,136,34895
1024,64,2,2,4,169,25,30880,132,31206
1024,64,2,2,4,169,26,34000,177,34372
1024,64,2,2,4,171,68,33431,143,33813
1024,64,2,2,4,169,28,33433,144,33774
1024,64,2,2,4,169,27,33200,133,33529
1024,64,2,2,4,169,25,32532,132,32858
1024,64,2,2,4,241,27,31423,136,31827
1024,128,1,2,4,173,26,26862,233,27294
1024,128,1,2,4,251,50,33668,152,34121
1024,128,1,2,4,169,29,32982,164,33344
1024,128,1,2,4,215,29,26857,134,27235
1024,128,1,2,4,169,25,31473,133,31800
1024,128,1,2,4,172,25,32174,133,32504
1024,128,1,2,4,169,26,26857,172,27224
1024,128,1,2,4,254,27,26854,132,27267
1024,128,1,2,4,169,27,33659,139,33994
1024,128,1,2,4,250,26,31294,132,31702
1024,1,256,2,2,169,25,30164,133,30491
1024,1,256,2,2,169,25,26688,178,27060
1024,1,256,2,2,169,26,26696,137,27028
1024,1,256,2,2,169,27,26694,137,27027
1024,1,256,2,2,173,27,30586,142,30928
1024,1,256,2,2,169,25,26693,159,27046
1024,1,256,2,2,231,39,28675,131,29076
1024,1,256,2,2,180,39,28679,141,29039
1024,1,256,2,2,173,27,26691,168,27059
1024,1,256,2,2,169,28,28654,135,28986
1024,2,128,2,2,169,26,26688,135,27018
1024,2,128,2,2,169,26,26690,204,27089
1024,2,128,2,2,169,50,28883,204,29306
1024,2,128,2,2,188,34,26877,139,27238
1024,2,128,2,2,173,27,31564,136,31900
1024,2,128,2,2,173,26,30915,134,31248
1024,2,128,2,2,173,27,29758,137,30095
1024,2,128,2,2,173,27,31661,142,32003
1024,2,128,2,2,222,27,30436,190,30875
1024,2,128,2,2,169,26,29972,147,30314
1024,4,64,2,2,277,41,30920,298,31536
1024,4,64,2,2,170,26,31035,132,31363
1024,4,64,2,2,169,25,31166,172,31532
1024,4,64,2,2,169,25,28198,135,28527
1024,4,64,2,2,169,25,33032,134,33360
1024,4,64,2,2,169,25,26689,152,27035
1024,4,64,2,2,169,27,29970,140,30306
1024,4,64,2,2,291,28,30805,144,31268
1024,4,64,2,2,169,27,26684,133,27013
1024,4,64,2,2,169,26,27775,139,28109
1024,8,32,2,2,169,26,35614,129,35938
1024,8,32,2,2,173,26,26685,147,27031
1024,8,32,2,2,173,28,36602,134,36937
1024,8,32,2,2,169,25,37853,183,38230
1024,8,32,2,2,169,26,34033,138,34366
1024,8,32,2,2,187,38,31881,196,32302
1024,8,32,2,2,214,31,32539,155,32939
1024,8,32,2,2,173,27,29684,257,30141
1024,8,32,2,2,169,27,33631,158,33985
1024,8,32,2,2,170,27,34990,138,35325
1024,16,16,2,2,173,27,35914,133,36247
1024,16,16,2,2,173,26,33769,139,34107
1024,16,16,2,2,173,26,33088,134,33421
1024,16,16,2,2,210,28,36772,239,37249
1024,16,16,2,2,169,26,28089,138,28422
1024,16,16,2,2,169,30,36317,154,36670
1024,16,16,2,2,169,26,34204,133,34532
1024,16,16,2,2,169,25,35354,135,35683
1024,16,16,2,2,173,25,35311,133,35642
1024,16,16,2,2,170,52,33371,318,33911
1024,32,8,2,2,169,26,26841,166,27202
1024,32,8,2,2,173,26,30199,167,30565
1024,32,8,2,2,256,32,26847,133,27268
1024,32,8,2,2,170,27,26839,134,27170
1024,32,8,2,2,169,26,31178,135,31508
1024,32,8,2,2,169,26,26836,159,27190
1024,32,8,2,2,187,26,29269,143,29625
1024,32,8,2,2,289,52,26850,134,27325
1024,32,8,2,2,188,34,26835,134,27191
1024,32,8,2,2,169,25,26840,136,27170
1024,64,4,2,2,224,33,32286,158,32701
1024,64,4,2,2,249,27,27870,299,28445
1024,64,4,2,2,169,26,31019,166,31380
1024,64,4,2,2,169,27,27938,142,28276
1024,64,4,2,2,174,40,26854,137,27205
1024,64,4,2,2,173,26,26855,151,27205
1024,64,4,2,2,169,25,26850,151,27195
1024,64,4,2,2,169,29,32192,146,32536
1024,64,4,2,2,174,27,31220,154,31575
1024,64,4,2,2,169,26,27547,176,27918
1024,128,2,2,2,174,30,26855,145,27204
1024,128,2,2,2,174,31,26852,132,27189
1024,128,2,2,2,169,26,26853,136,27184
1024,128,2,2,2,169,27,26849,148,27193
1024,128,2,2,2,169,28,26848,132,27177
1024,128,2,2,2,174,28,26855,131,27188
1024,128,2,2,2,218,28,26844,129,27219
1024,128,2,2,2,173,26,26861,131,27191
1024,128,2,2,2,173,25,30269,152,30619
1024,128,2,2,2,169,27,26847,149,27192
1024,256,1,2,2,169,28,26838,135,27170
1024,256,1,2,2,169,26,26841,140,27176
1024,256,1,2,2,169,26,26844,240,27279
1024,256,1,2,2,256,38,26848,131,27273
1024,256,1,2,2,173,26,26837,133,27169
1024,256,1,2,2,173,26,26838,230,27267
1024,256,1,2,2,172,26,26833,134,27165
1024,256,1,2,2,170,40,26849,140,27199
1024,256,1,2,2,202,26,26841,145,27214
1024,256,1,2,2,169,28,26837,132,27166
2048,1,32,8,8,340,39,80857,149,81385
2048,1,32,8,8,338,29,79524,146,80037
2048,1,32,8,8,491,62,79078,143,79774
2048,1,32,8,8,409,29,75545,138,76121
2048,1,32,8,8,338,29,82042,143,82552
2048,1,32,8,8,338,29,82155,141,82663
2048,1,32,8,8,338,29,73387,139,73893
2048,1,32,8,8,495,32,81326,471,82324
2048,1,32,8,8,620,62,81949,251,82882
2048,1,32,8,8,337,29,79585,176,80127
2048,2,16,8,8,337,29,81580,178,82124
2048,2,16,8,8,558,43,82198,143,82942
2048,2,16,8,8,338,28,83395,137,83898
2048,2,16,8,8,524,33,82472,141,83170
2048,2,16,8,8,433,41,80894,210,81578
2048,2,16,8,8,337,28,83577,140,84082
2048,2,16,8,8,338,29,79952,141,80460
2048,2,16,8,8,338,28,80613,159,81138
2048,2,16,8,8,347,30,79047,268,79692
2048,2,16,8,8,338,30,78666,143,79177
2048,4,8,8,8,449,30,81611,140,82230
2048,4,8,8,8,390,29,79298,151,79868
2048,4,8,8,8,337,29,84412,140,84918
2048,4,8,8,8,338,29,83737,142,84246
2048,4,8,8,8,338,28,81497,145,82008
2048,4,8,8,8,346,29,83477,144,83996
2048,4,8,8,8,346,29,82378,141,82894
2048,4,8,8,8,346,29,81067,140,81582
2048,4,8,8,8,346,29,85813,139,86327
2048,4,8,8,8,467,38,84333,187,85025
2048,8,4,8,8,346,31,80522,195,81094
2048,8,4,8,8,349,30,79514,208,80101
2048,8,4,8,8,519,30,81055,171,81775
2048,8,4,8,8,338,29,79707,160,80234
2048,8,4,8,8,346,29,81253,163,81791
2048,8,4,8,8,346,30,83065,161,83602
2048,8,4,8,8,349,31,82118,162,82660
2048,8,4,8,8,338,29,81440,144,81951
2048,8,4,8,8,346,30,80114,156,80646
2048,8,4,8,8,338,30,78953,185,79506
2048,16,2,8,8,338,34,79371,152,79895
2048,16,2,8,8,396,41,81109,150,81696
2048,16,2,8,8,405,104,80845,139,81493
2048,16,2,8,8,338,30,83018,242,83628
2048,16,2,8,8,338,31,80955,158,81482
2048,16,2,8,8,508,33,81083,199,81823
2048,16,2,8,8,338,31,80925,160,81454
2048,16,2,8,8,338,29,81666,152,82185
2048,16,2,8,8,347,31,78718,240,79336
2048,16,2,8,8,496,31,81276,160,81963
2048,32,1,8,8,361,31,82080,162,82634
2048,32,1,8,8,338,31,82523,160,83052
2048,32,1,8,8,338,31,82446,146,82961
2048,32,1,8,8,338,31,82207,160,82736
2048,32,1,8,8,374,30,80163,157,80724
2048,32,1,8,8,337,29,80330,141,80837
2048,32,1,8,8,346,29,85888,142,86405
2048,32,1,8,8,338,29,84062,140,84569
2048,32,1,8,8,338,29,82310,160,82837
2048,32,1,8,8,429,31,85970,163,86593
2048,1,64,4,8,347,29,79592,157,80125
2048,1,64,4,8,337,28,81809,183,82357
2048,1,64,4,8,352,31,80691,139,81213
2048,1,64,4,8,346,29,78816,139,79330
2048,1,64,4,8,338,29,80466,142,80975
2048,1,64,4,8,402,31,82754,142,83329
2048,1,64,4,8,607,80,80687,140,81514
2048,1,64,4,8,502,36,81800,252,82590
2048,1,64,4,8,578,38,82270,267,83153
2048,1,64,4,8,386,31,86316,141,86874
2048,2,32,4,8,338,30,82219,140,82727
2048,2,32,4,8,457,73,78218,169,78917
2048,2,32,4,8,347,32,81295,192,81866
2048,2,32,4,8,348,29,82531,143,83051
2048,2,32,4,8,338,29,86154,139,86660
2048,2,32,4,8,338,28,82551,146,83063
2048,2,32,4,8,338,28,76410,148,76924
2048,2,32,4,8,355,44,82959,154,83512
2048,2,32,4,8,351,41,82975,172,83539
2048,2,32,4,8,347,30,83139,174,83690
2048,4,16,4,8,440,35,76736,141,77352
2048,4,16,4,8,337,28,80829,138,81332
2048,4,16,4,8,337,30,84430,160,84957
2048,4,16,4,8,347,30,79171,143,79691
2048,4,16,4,8,337,29,82694,139,83199
2048,4,16,4,8,338,29,86178,143,86688
2048,4,16,4,8,388,29,84119,165,84701
2048,4,16,4,8,338,32,79775,154,80299
2048,4,16,4,8,339,31,83106,153,83629
2048,4,16,4,8,339,30,80674,142,81185
2048,8,8,4,8,338,29,82814,145,83326
2048,8,8,4,8,546,34,83042,308,83930
2048,8,8,4,8,485,30,86675,140,87330
2048,8,8,4,8,337,29,83152,144,83662
2048,8,8,4,8,338,28,82727,143,83236
2048,8,8,4,8,338,29,83744,138,84249
2048,8,8,4,8,338,29,81869,142,82378
2048,8,8,4,8,433,29,82171,153,82786
2048,8,8,4,8,415,29,82965,167,83576
2048,8,8,4,8,338,29,83598,141,84106
2048,16,4,4,8,393,29,81058,174,81654
2048,16,4,4,8,390,33,85431,147,86001
2048,16,4,4,8,346,30,81558,164,82098
2048,16,4,4,8,338,30,86839,143,87350
2048,16,4,4,8,338,29,82766,140,83273
2048,16,4,4,8,337,29,82445,143,82954
2048,16,4,4,8,337,31,82964,161,83493
2048,16,4,4,8,493,42,83231,143,83909
2048,16,4,4,8,338,29,80272,154,80793
2048,16,4,4,8,400,31,82883,149,83463
2048,32,2,4,8,349,30,85327,142,85848
2048,32,2,4,8,337,29,85248,146,85760
2048,32,2,4,8,338,29,86712,140,87219
2048,32,2,4,8,346,29,90187,158,90720
2048,32,2,4,8,506,33,83395,153,84087
2048,32,2,4,8,337,28,87332,146,87843
2048,32,2,4,8,338,29,85188,138,85693
2048,32,2,4,8,338,28,84342,147,84855
2048,32,2,4,8,338,29,84315,225,84907
2048,32,2,4,8,450,36,83682,147,84315
2048,64,1,4,8,337,29,73600,319,74285
2048,64,1,4,8,338,29,76783,152,77302
2048,64,1,4,8,348,42,82297,180,82867
2048,64,1,4,8,339,33,78011,143,78526
2048,64,1,4,8,337,28,78564,148,79077
2048,64,1,4,8,338,29,80888,164,81419
2048,64,1,4,8,339,30,74337,139,74845
2048,64,1,4,8,338,29,85342,207,85916
2048,64,1,4,8,339,36,77238,132,77745
2048,64,1,4,8,337,74,81312,140,81863
2048,1,128,4,4,429,30,81112,157,81728
2048,1,128,4,4,338,29,81124,142,81633
2048,1,128,4,4,346,29,81127,169,81671
2048,1,128,4,4,347,32,81118,155,81652
2048,1,128,4,4,338,36,81102,195,81671
2048,1,128,4,4,339,30,82839,233,83441
2048,1,128,4,4,652,43,81800,172,82667
2048,1,128,4,4,339,34,81122,266,81761
2048,1,128,4,4,346,31,81105,182,81664
2048,1,128,4,4,339,33,81091,160,81623
2048,2,64,4,4,344,32,81969,163,82508
2048,2,64,4,4,338,29,85812,140,86319
2048,2,64,4,4,346,29,81257,142,81774
2048,2,64,4,4,338,28,81816,160,82342
2048,2,64,4,4,384,30,81464,161,82039
2048,2,64,4,4,339,33,81487,158,82017
2048,2,64,4,4,338,32,82807,169,83346
2048,2,64,4,4,337,29,85414,143,85923
2048,2,64,4,4,348,31,81472,142,81993
2048,2,64,4,4,338,28,81467,154,81987
2048,4,32,4,4,338,29,80490,140,80997
2048,4,32,4,4,338,30,81880,145,82393
2048,4,32,4,4,346,31,81865,204,82446
2048,4,32,4,4,422,42,77777,150,78391
2048,4,32,4,4,337,29,78575,142,79083
2048,4,32,4,4,338,29,81498,140,82005
2048,4,32,4,4,379,28,81479,141,82027
2048,4,32,4,4,338,41,75637,151,76167
2048,4,32,4,4,338,28,81771,187,82324
2048,4,32,4,4,338,29,79969,147,80483
2048,8,16,4,4,338,30,80813,261,81442
2048,8,16,4,4,338,29,76932,137,77436
2048,8,16,4,4,423,39,80088,143,80693
2048,8,16,4,4,405,36,78915,147,79503
2048,8,16,4,4,348,29,82244,132,82753
2048,8,16,4,4,340,35,85286,201,85862
2048,8,16,4,4,543,33,82059,175,82810
2048,8,16,4,4,338,29,78744,270,79381
2048,8,16,4,4,384,30,80074,157,80645
2048,8,16,4,4,360,31,81797,139,82327
2048,16,8,4,4,525,32,82656,145,83358
2048,16,8,4,4,482,30,80635,157,81304
2048,16,8,4,4,347,31,84774,139,85291
2048,16,8,4,4,338,29,86584,149,87100
2048,16,8,4,4,575,127,88288,163,89153
2048,16,8,4,4,347,29,85039,155,85570
2048,16,8,4,4,346,29,81998,138,82511
2048,16,8,4,4,338,28,88365,137,88868
2048,16,8,4,4,340,32,81866,146,82384
2048,16,8,4,4,349,33,89175,192,89749
2048,32,4,4,4,346,29,80281,152,80808
2048,32,4,4,4,347,29,82401,164,82941
2048,32,4,4,4,347,33,83406,160,83946
2048,32,4,4,4,338,31,84015,141,84525
2048,32,4,4,4,338,29,83624,149,84140
2048,32,4,4,4,338,29,84465,145,84977
2048,32,4,4,4,347,32,83910,243,84532
2048,32,4,4,4,346,29,81486,144,82005
2048,32,4,4,4,355,30,80896,146,81427
2048,32,4,4,4,374,43,82489,199,83105
2048,64,2,4,4,347,29,75702,160,76238
2048,64,2,4,4,356,31,77615,180,78182
2048,64,2,4,4,346,29,81726,150,82251
2048,64,2,4,4,346,29,79760,141,80276
2048,64,2,4,4,346,29,83820,152,84347
2048,64,2,4,4,338,28,82516,141,83023
2048,64,2,4,4,338,28,77907,140,78413
2048,64,2,4,4,492,33,84394,142,85061
2048,64,2,4,4,338,29,85659,145,86171
2048,64,2,4,4,364,33,85649,172,86218
2048,128,1,4,4,338,119,82719,153,83329
2048,128,1,4,4,393,29,88150,141,88713
2048,128,1,4,4,337,29,69611,147,70124
2048,128,1,4,4,339,30,73085,193,73647
2048,128,1,4,4,347,32,81086,148,81613
2048,128,1,4,4,338,29,72548,140,73055
2048,128,1,4,4,347,29,69611,191,70178
2048,128,1,4,4,418,32,87459,150,88059
2048,128,1,4,4,338,29,87448,141,87956
2048,128,1,4,4,362,29,82841,139,83371
2048,1,256,2,4,338,28,55007,151,55524
2048,1,256,2,4,541,35,64074,159,64809
2048,1,256,2,4,485,41,55017,179,55722
2048,1,256,2,4,411,46,63988,139,64584
2048,1,256,2,4,338,29,54998,160,55525
2048,1,256,2,4,369,38,63998,140,64545
2048,1,256,2,4,338,30,55009,149,55526
2048,1,256,2,4,338,29,55003,139,55509
2048,1,256,2,4,346,29,55011,197,55583
2048,1,256,2,4,338,30,55004,138,55510
2048,2,128,2,4,338,34,78585,151,79108
2048,2,128,2,4,338,30,66685,148,67201
2048,2,128,2,4,338,29,73695,179,74241
2048,2,128,2,4,392,29,66521,139,67081
2048,2,128,2,4,352,30,74449,150,74981
2048,2,128,2,4,338,31,74213,144,74726
2048,2,128,2,4,337,29,66853,139,67358
2048,2,128,2,4,338,29,78591,146,79104
2048,2,128,2,4,338,29,55013,162,55542
2048,2,128,2,4,381,74,74168,151,74774
2048,4,64,2,4,386,32,73866,164,74448
2048,4,64,2,4,346,32,74441,143,74962
2048,4,64,2,4,337,29,66547,148,67061
2048,4,64,2,4,341,28,74912,168,75449
2048,4,64,2,4,338,30,54999,186,55553
2048,4,64,2,4,337,28,74448,227,75040
2048,4,64,2,4,381,43,65423,211,66058
2048,4,64,2,4,355,51,55010,147,55563
2048,4,64,2,4,423,31,80102,152,80708
2048,4,64,2,4,403,48,79555,153,80159
2048,8,32,2,4,338,29,55001,167,55535
2048,8,32,2,4,338,29,74592,146,75105
2048,8,32,2,4,338,29,54996,173,55536
2048,8,32,2,4,338,31,65735,214,66318
2048,8,32,2,4,338,29,74516,197,75080
2048,8,32,2,4,383,35,66026,148,66592
2048,8,32,2,4,349,30,54998,167,55544
2048,8,32,2,4,338,30,74247,139,74754
2048,8,32,2,4,347,30,74988,145,75510
2048,8,32,2,4,338,29,55001,137,55505
2048,16,16,2,4,337,29,74605,154,75125
2048,16,16,2,4,338,29,79511,191,80069
2048,16,16,2,4,448,35,83890,178,84551
2048,16,16,2,4,492,37,77514,144,78187
2048,16,16,2,4,338,29,79190,142,79699
2048,16,16,2,4,337,28,78774,173,79312
2048,16,16,2,4,338,28,80463,204,81033
2048,16,16,2,4,346,29,76369,149,76893
2048,16,16,2,4,338,29,73833,144,74344
2048,16,16,2,4,380,29,77777,250,78436
2048,32,8,2,4,557,45,65649,202,66453
2048,32,8,2,4,508,32,63161,194,63895
2048,32,8,2,4,395,34,64417,202,65048
2048,32,8,2,4,347,30,64701,164,65242
2048,32,8,2,4,500,81,61740,136,62457
2048,32,8,2,4,387,44,56816,166,57413
2048,32,8,2,4,337,28,63372,156,63893
2048,32,8,2,4,338,29,64635,196,65198
2048,32,8,2,4,337,31,54970,140,55478
2048,32,8,2,4,337,29,63117,141,63624
2048,64,4,2,4,338,28,63670,142,64178
2048,64,4,2,4,508,29,62123,138,62798
2048,64,4,2,4,498,30,63567,155,64250
2048,64,4,2,4,338,29,62094,174,62635
2048,64,4,2,4,338,31,65342,199,65910
2048,64,4,2,4,382,29,65694,148,66253
2048,64,4,2,4,346,29,64760,147,65282
2048,64,4,2,4,346,29,54966,165,55506
2048,64,4,2,4,556,37,63287,141,64021
2048,64,4,2,4,340,35,57577,137,58089
2048,128,2,2,4,338,28,65880,139,66385
2048,128,2,2,4,337,29,63689,142,64197
2048,128,2,2,4,337,28,66485,140,66990
2048,128,2,2,4,338,28,68179,137,68682
2048,128,2,2,4,508,31,63877,189,64605
2048,128,2,2,4,338,30,66027,150,66545
2048,128,2,2,4,338,32,63880,178,64428
2048,128,2,2,4,339,40,63414,164,63957
2048,128,2,2,4,339,32,54958,137,55466
2048,128,2,2,4,346,29,66465,147,66987
2048,256,1,2,4,337,28,69330,160,69855
2048,256,1,2,4,338,32,69607,143,70120
2048,256,1,2,4,384,29,68979,140,69532
2048,256,1,2,4,338,29,68866,138,69371
2048,256,1,2,4,338,28,69296,163,69825
2048,256,1,2,4,485,32,69294,151,69962
2048,256,1,2,4,521,30,68808,138,69497
2048,256,1,2,4,338,28,68869,142,69377
2048,256,1,2,4,353,34,69304,193,69884
2048,256,1,2,4,405,31,66696,250,67382
4096,1,32,8,16,1411,57,176516,168,178152
4096,1,32,8,16,693,38,173664,204,174599
4096,1,32,8,16,693,39,168503,156,169391
4096,1,32,8,16,675,37,169608,159,170479
4096,1,32,8,16,860,59,169385,240,170544
4096,1,32,8,16,1369,85,174316,177,175947
4096,1,32,8,16,796,40,172191,154,173181
4096,1,32,8,16,675,37,174790,194,175696
4096,1,32,8,16,726,37,169512,151,170426
4096,1,32,8,16,692,37,173733,225,174687
4096,2,16,8,16,872,59,172898,152,173981
4096,2,16,8,16,675,37,175190,162,176064
4096,2,16,8,16,675,37,169168,165,170045
4096,2,16,8,16,725,38,166623,147,167533
4096,2,16,8,16,675,37,170841,167,171720
4096,2,16,8,16,976,46,174559,153,175734
4096,2,16,8,16,675,37,155206,169,156087
4096,2,16,8,16,693,39,181530,214,182476
4096,2,16,8,16,675,40,173426,151,174292
4096,2,16,8,16,677,37,171275,240,172229
4096,4,8,8,16,676,41,169114,153,169984
4096,4,8,8,16,675,37,169996,154,170862
4096,4,8,8,16,675,37,172859,166,173737
4096,4,8,8,16,676,40,169132,161,170009
4096,4,8,8,16,675,36,167779,156,168646
4096,4,8,8,16,692,38,174171,172,175073
4096,4,8,8,16,676,41,168224,155,169096
4096,4,8,8,16,725,37,168305,261,169328
4096,4,8,8,16,1161,57,173481,155,174854
4096,4,8,8,16,710,39,167897,167,168813
4096,8,4,8,16,736,51,169824,174,170785
4096,8,4,8,16,675,37,166082,151,166945
4096,8,4,8,16,675,37,168778,151,169641
4096,8,4,8,16,692,37,174562,174,175465
4096,8,4,8,16,675,37,169125,154,169991
4096,8,4,8,16,675,37,175831,169,176712
4096,8,4,8,16,692,39,173117,149,173997
4096,8,4,8,16,930,38,167523,148,168639
4096,8,4,8,16,1094,96,172213,150,173553
4096,8,4,8,16,675,37,177067,172,177951
4096,16,2,8,16,675,40,168970,150,169835
4096,16,2,8,16,675,36,167624,197,168532
4096,16,2,8,16,675,38,160530,149,161392
4096,16,2,8,16,675,37,168458,153,169323
4096,16,2,8,16,692,39,166197,154,167082
4096,16,2,8,16,675,37,175274,187,176173
4096,16,2,8,16,676,47,165862,161,166746
4096,16,2,8,16,702,38,170778,155,171673
4096,16,2,8,16,675,38,168464,158,169335
4096,16,2,8,16,679,62,169163,218,170122
4096,32,1,8,16,784,38,175521,163,176506
4096,32,1,8,16,692,38,182799,150,183679
4096,32,1,8,16,692,37,174184,243,175156
4096,32,1,8,16,675,36,171568,199,172478
4096,32,1,8,16,756,42,177347,188,178333
4096,32,1,8,16,675,36,168743,285,169739
4096,32,1,8,16,692,42,172044,155,172933
4096,32,1,8,16,675,36,169081,151,169943
4096,32,1,8,16,675,36,170208,179,171098
4096,32,1,8,16,693,39,170788,171,171691
4096,1,64,8,8,718,44,170460,159,171381
4096,1,64,8,8,711,37,172021,165,172934
4096,1,64,8,8,1013,40,168849,167,170069
4096,1,64,8,8,692,37,173563,234,174526
4096,1,64,8,8,998,56,165502,162,166718
4096,1,64,8,8,678,38,173269,224,174209
4096,1,64,8,8,725,39,172791,150,173705
4096,1,64,8,8,680,50,174551,155,175436
4096,1,64,8,8,675,37,164902,154,165768
4096,1,64,8,8,727,37,176185,293,177242
4096,2,32,8,8,676,38,164218,199,165131
4096,2,32,8,8,675,40,167349,178,168242
4096,2,32,8,8,675,38,167434,157,168304
4096,2,32,8,8,675,37,165382,154,166248
4096,2,32,8,8,675,45,166417,157,167294
4096,2,32,8,8,675,37,167187,157,168056
4096,2,32,8,8,675,37,165410,161,166283
4096,2,32,8,8,692,38,173091,177,173998
4096,2,32,8,8,945,63,168008,155,169171
4096,2,32,8,8,692,38,168984,154,169868
4096,4,16,8,8,675,37,174525,201,175438
4096,4,16,8,8,677,39,173650,153,174519
4096,4,16,8,8,675,37,170157,149,171018
4096,4,16,8,8,725,45,169867,164,170801
4096,4,16,8,8,725,37,164742,173,165677
4096,4,16,8,8,693,40,164492,185,165410
4096,4,16,8,8,675,40,168796,153,169664
4096,4,16,8,8,692,46,172172,157,173067
4096,4,16,8,8,725,38,179045,151,179959
4096,4,16,8,8,675,37,165131,152,165995
4096,8,8,8,8,724,37,174618,244,175623
4096,8,8,8,8,1082,107,174088,151,175428
4096,8,8,8,8,675,36,179849,166,180726
4096,8,8,8,8,724,39,174967,220,175950
4096,8,8,8,8,702,39,171326,153,172220
4096,8,8,8,8,715,50,173485,151,174401
4096,8,8,8,8,676,39,168436,151,169302
4096,8,8,8,8,692,37,168152,150,169031
4096,8,8,8,8,719,44,169505,176,170444
4096,8,8,8,8,675,41,169274,153,170143
4096,16,4,8,8,675,36,175804,172,176687
4096,16,4,8,8,733,39,176040,191,177003
4096,16,4,8,8,781,47,177273,156,178257
4096,16,4,8,8,703,57,174040,155,174955
4096,16,4,8,8,675,37,175418,185,176315
4096,16,4,8,8,991,48,187087,174,188300
4096,16,4,8,8,774,40,172839,168,173821
4096,16,4,8,8,870,51,173088,153,174162
4096,16,4,8,8,726,37,182165,153,183081
4096,16,4,8,8,675,37,174084,177,174973
4096,32,2,8,8,678,37,177562,187,178464
4096,32,2,8,8,746,48,181782,153,182729
4096,32,2,8,8,675,37,175268,153,176133
4096,32,2,8,8,856,62,181296,162,182376
4096,32,2,8,8,692,37,181757,154,182640
4096,32,2,8,8,702,38,179009,153,179902
4096,32,2,8,8,847,46,172200,166,173259
4096,32,2,8,8,734,49,177153,192,178128
4096,32,2,8,8,689,50,174263,150,175152
4096,32,2,8,8,675,37,174051,199,174962
4096,64,1,8,8,691,39,175387,176,176293
4096,64,1,8,8,771,41,174323,200,175335
4096,64,1,8,8,1029,50,175123,279,176481
4096,64,1,8,8,690,43,180294,162,181189
4096,64,1,8,8,850,62,178297,154,179363
4096,64,1,8,8,839,82,176969,155,178045
4096,64,1,8,8,675,36,178185,152,179048
4096,64,1,8,8,675,37,182119,159,182990
4096,64,1,8,8,997,41,178812,174,180024
4096,64,1,8,8,703,39,180737,178,181657
4096,1,128,4,8,675,38,172376,154,173243
4096,1,128,4,8,675,37,172711,158,173581
4096,1,128,4,8,697,42,172968,155,173862
4096,1,128,4,8,692,37,165667,156,166552
4096,1,128,4,8,723,39,172448,159,173369
4096,1,128,4,8,813,47,166140,165,167165
4096,1,128,4,8,747,38,172511,185,173481
4096,1,128,4,8,675,36,176110,208,177029
4096,1,128,4,8,697,40,185380,154,186271
4096,1,128,4,8,675,37,184348,154,185214
4096,2,64,4,8,675,37,187690,159,188561
4096,2,64,4,8,703,71,177535,162,178471
4096,2,64,4,8,826,37,173204,162,174229
4096,2,64,4,8,675,37,178872,182,179766
4096,2,64,4,8,675,37,168993,155,169860
4096,2,64,4,8,675,37,160404,210,161326
4096,2,64,4,8,733,41,173826,149,174749
4096,2,64,4,8,675,38,172156,275,173144
4096,2,64,4,8,688,37,187443,170,188338
4096,2,64,4,8,723,37,165487,149,166396
4096,4,32,4,8,675,37,173163,677,174552
4096,4,32,4,8,675,37,176954,154,177820
4096,4,32,4,8,920,54,178131,159,179264
4096,4,32,4,8,675,36,179581,156,180448
4096,4,32,4,8,675,37,170133,159,171004
4096,4,32,4,8,906,56,172641,169,173772
4096,4,32,4,8,692,37,177815,161,178705
4096,4,32,4,8,676,40,173544,153,174413
4096,4,32,4,8,675,37,173777,189,174678
4096,4,32,4,8,675,40,176259,165,177139
4096,8,16,4,8,675,37,177535,156,178403
4096,8,16,4,8,675,36,175298,164,176173
4096,8,16,4,8,1014,49,180332,201,181596
4096,8,16,4,8,678,41,166878,191,167788
4096,8,16,4,8,707,40,178477,237,179461
4096,8,16,4,8,692,38,173748,195,174673
4096,8,16,4,8,777,42,182745,164,183728
4096,8,16,4,8,774,44,178608,158,179584
4096,8,16,4,8,694,39,173077,154,173964
4096,8,16,4,8,675,37,177601,153,178466
4096,16,8,4,8,675,37,180427,204,181343
4096,16,8,4,8,846,41,186539,155,187581
4096,16,8,4,8,675,37,181048,151,181911
4096,16,8,4,8,888,58,183006,154,184106
4096,16,8,4,8,675,38,180283,157,181153
4096,16,8,4,8,675,37,183416,236,184364
4096,16,8,4,8,863,45,178325,157,179390
4096,16,8,4,8,693,39,180180,200,181112
4096,16,8,4,8,728,73,186881,165,187847
4096,16,8,4,8,1093,58,174572,157,175880
4096,32,4,4,8,675,36,178142,151,179004
4096,32,4,4,8,692,37,176716,164,177609
4096,32,4,4,8,675,36,181927,151,182789
4096,32,4,4,8,693,38,185400,154,186285
4096,32,4,4,8,675,37,182288,152,183152
4096,32,4,4,8,675,37,172558,203,173473
4096,32,4,4,8,991,39,183852,154,185036
4096,32,4,4,8,675,37,175551,255,176518
4096,32,4,4,8,694,47,178231,154,179126
4096,32,4,4,8,676,37,186013,287,187013
4096,64,2,4,8,693,42,182730,226,183691
4096,64,2,4,8,709,46,181811,207,182773
4096,64,2,4,8,677,41,180252,329,181299
4096,64,2,4,8,715,64,176665,153,177597
4096,64,2,4,8,676,38,174917,151,175782
4096,64,2,4,8,693,38,180563,152,181446
4096,64,2,4,8,676,37,170942,152,171807
4096,64,2,4,8,675,37,184944,164,185820
4096,64,2,4,8,686,54,181988,168,182896
4096,64,2,4,8,693,43,177726,150,178612
4096,128,1,4,8,757,54,174129,164,175104
4096,128,1,4,8,825,39,177500,154,178518
4096,128,1,4,8,675,37,172044,150,172906
4096,128,1,4,8,711,38,172975,174,173898
4096,128,1,4,8,692,38,181799,155,182684
4096,128,1,4,8,703,38,170939,150,171830
4096,128,1,4,8,675,37,184264,161,185137
4096,128,1,4,8,676,38,178309,158,179181
4096,128,1,4,8,1259,81,182707,165,184212
4096,128,1,4,8,1073,64,183600,182,184919
4096,1,256,4,4,733,38,135866,157,136794
4096,1,256,4,4,675,36,163925,154,164790
4096,1,256,4,4,722,37,146982,158,147899
4096,1,256,4,4,692,38,163929,169,164828
4096,1,256,4,4,742,38,161509,167,162456
4096,1,256,4,4,1096,43,163941,212,165292
4096,1,256,4,4,790,39,163943,169,164941
4096,1,256,4,4,692,38,163928,175,164833
4096,1,256,4,4,693,78,163933,176,164880
4096,1,256,4,4,676,38,163926,164,164804
4096,2,128,4,4,686,39,162871,292,163888
4096,2,128,4,4,692,38,164632,162,165524
4096,2,128,4,4,675,40,163554,193,164462
4096,2,128,4,4,735,45,163843,198,164821
4096,2,128,4,4,676,41,163127,199,164043
4096,2,128,4,4,692,38,160458,274,161462
4096,2,128,4,4,694,43,164378,170,165285
4096,2,128,4,4,727,43,164692,173,165635
4096,2,128,4,4,675,37,163548,181,164441
4096,2,128,4,4,718,38,161265,146,162167
4096,4,64,4,4,675,37,162837,154,163703
4096,4,64,4,4,675,37,164145,175,165032
4096,4,64,4,4,676,38,163292,166,164172
4096,4,64,4,4,692,38,163082,168,163980
4096,4,64,4,4,717,45,165600,160,166522
4096,4,64,4,4,710,39,163096,175,164020
4096,4,64,4,4,677,41,163982,175,164875
4096,4,64,4,4,765,39,162797,179,163780
4096,4,64,4,4,881,91,162686,285,163943
4096,4,64,4,4,693,39,162918,219,163869
4096,8,32,4,4,749,54,173005,153,173961
4096,8,32,4,4,676,38,173608,154,174476
4096,8,32,4,4,705,37,170117,153,171012
4096,8,32,4,4,675,37,170878,192,171782
4096,8,32,4,4,1016,44,170341,162,171563
4096,8,32,4,4,675,38,168976,153,169842
4096,8,32,4,4,675,36,169083,173,169967
4096,8,32,4,4,683,45,160431,151,161310
4096,8,32,4,4,675,37,164524,156,165392
4096,8,32,4,4,720,38,174243,171,175172
4096,16,16,4,4,725,43,170252,158,171178
4096,16,16,4,4,676,45,184935,161,185817
4096,16,16,4,4,857,38,171701,213,172809
4096,16,16,4,4,682,42,172821,165,173710
4096,16,16,4,4,675,36,171148,149,172008
4096,16,16,4,4,773,39,167590,154,168556
4096,16,16,4,4,829,36,171720,176,172761
4096,16,16,4,4,675,37,172860,153,173725
4096,16,16,4,4,1048,38,175256,163,176505
4096,16,16,4,4,726,37,177507,169,178439
4096,32,8,4,4,675,39,185941,167,186822
4096,32,8,4,4,680,36,177075,191,177982
4096,32,8,4,4,993,45,174033,156,175227
4096,32,8,4,4,675,38,173307,168,174188
4096,32,8,4,4,677,52,175966,160,176855
4096,32,8,4,4,685,37,177818,158,178698
4096,32,8,4,4,675,37,180632,150,181494
4096,32,8,4,4,675,37,180005,155,180872
4096,32,8,4,4,682,37,188381,146,189246
4096,32,8,4,4,675,37,183028,151,183891
4096,64,4,4,4,676,37,179725,153,180591
4096,64,4,4,4,675,37,184836,156,185704
4096,64,4,4,4,675,37,182473,151,183336
4096,64,4,4,4,675,36,185616,203,186530
4096,64,4,4,4,735,42,185879,149,186805
4096,64,4,4,4,699,40,183730,155,184624
4096,64,4,4,4,725,37,183259,159,184180
4096,64,4,4,4,675,36,182454,155,183320
4096,64,4,4,4,786,38,174736,207,175767
4096,64,4,4,4,675,37,181553,155,182420
4096,128,2,4,4,693,37,180843,155,181728
4096,128,2,4,4,677,40,183863,150,184730
4096,128,2,4,4,675,37,181379,153,182244
4096,128,2,4,4,692,37,170407,151,171287
4096,128,2,4,4,675,37,181273,152,182137
4096,128,2,4,4,675,36,172530,207,173448
4096,128,2,4,4,792,42,175558,167,176559
4096,128,2,4,4,715,49,173854,165,174783
4096,128,2,4,4,695,37,182366,154,183252
4096,128,2,4,4,675,37,167842,150,168704
4096,256,1,4,4,1126,62,174128,155,175471
4096,256,1,4,4,692,37,168331,148,169208
4096,256,1,4,4,741,69,169161,182,170153
4096,256,1,4,4,675,37,165321,156,166189
4096,256,1,4,4,675,37,168300,179,169191
4096,256,1,4,4,693,40,166623,154,167510
4096,256,1,4,4,675,37,167310,152,168174
4096,256,1,4,4,681,42,168313,183,169219
4096,256,1,4,4,678,43,166502,154,167377
4096,256,1,4,4,675,36,166480,160,167351
8192,1,32,16,16,1353,49,608382,218,610002
8192,1,32,16,16,1467,58,607786,272,609583
8192,1,32,16,16,2242,87,612408,177,614914
8192,1,32,16,16,1379,49,632310,177,633915
8192,1,32,16,16,1398,48,603297,293,605036
8192,1,32,16,16,1385,71,623151,181,624788
8192,1,32,16,16,1385,49,612287,207,613928
8192,1,32,16,16,1385,49,610879,178,612491
8192,1,32,16,16,1396,49,612768,179,614392
8192,1,32,16,16,1534,157,606560,179,608430
8192,2,16,16,16,1385,49,610230,263,611927
8192,2,16,16,16,1392,89,611270,170,612921
8192,2,16,16,16,1350,48,608644,177,610219
8192,2,16,16,16,1349,48,608794,183,610374
8192,2,16,16,16,1488,61,559143,189,560881
8192,2,16,16,16,1350,48,572110,212,573720
8192,2,16,16,16,1399,47,571374,274,573094
8192,2,16,16,16,1431,60,556152,176,557819
8192,2,16,16,16,1446,62,608462,225,610195
8192,2,16,16,16,1384,49,607857,270,609560
8192,4,8,16,16,1378,52,616762,1640,619832
8192,4,8,16,16,1370,49,608020,183,609622
8192,4,8,16,16,1402,49,568329,179,569959
8192,4,8,16,16,1431,138,633330,301,635200
8192,4,8,16,16,1858,113,608929,176,611076
8192,4,8,16,16,1399,51,609100,242,610792
8192,4,8,16,16,1399,74,576919,250,578642
8192,4,8,16,16,1385,49,615073,184,616691
8192,4,8,16,16,1386,67,614053,197,615703
8192,4,8,16,16,1353,48,608295,255,609951
8192,8,4,16,16,1350,49,618484,199,620082
8192,8,4,16,16,1385,49,602642,178,604254
8192,8,4,16,16,1466,109,611558,177,613310
8192,8,4,16,16,1349,49,612411,183,613992
8192,8,4,16,16,1384,49,616569,176,618178
8192,8,4,16,16,1456,61,611314,258,613089
8192,8,4,16,16,1961,102,614085,271,616419
8192,8,4,16,16,1587,55,619664,190,621496
8192,8,4,16,16,1702,57,561942,222,563923
8192,8,4,16,16,1384,75,606966,181,608606
8192,16,2,16,16,1422,52,581436,189,583099
8192,16,2,16,16,1628,59,615005,218,616910
8192,16,2,16,16,1350,48,628083,226,629707
8192,16,2,16,16,1420,63,598039,304,599826
8192,16,2,16,16,1640,51,627731,278,629700
8192,16,2,16,16,1468,118,627088,178,628852
8192,16,2,16,16,1465,62,636620,194,638341
8192,16,2,16,16,1350,47,613322,192,614911
8192,16,2,16,16,1436,55,620588,190,622269
8192,16,2,16,16,1454,52,569346,175,571027
8192,32,1,16,16,1428,51,591878,220,593577
8192,32,1,16,16,1494,55,603332,193,605074
8192,32,1,16,16,1964,65,609807,183,612019
8192,32,1,16,16,1352,61,594272,200,595885
8192,32,1,16,16,1997,76,585051,180,587304
8192,32,1,16,16,2032,51,571459,182,573724
8192,32,1,16,16,1424,49,616511,180,618164
8192,32,1,16,16,1350,47,585667,249,587313
8192,32,1,16,16,1421,49,619331,188,620989
8192,32,1,16,16,1448,69,584536,222,586275
8192,1,64,8,16,1403,65,465097,181,466746
8192,1,64,8,16,1521,85,471381,180,473167
8192,1,64,8,16,1351,54,457557,189,459151
8192,1,64,8,16,1585,73,461024,178,462860
8192,1,64,8,16,1398,49,462000,178,463625
8192,1,64,8,16,1393,50,474672,202,476317
8192,1,64,8,16,1564,66,463954,206,465790
8192,1,64,8,16,1416,51,452091,175,453733
8192,1,64,8,16,1653,98,465767,246,467764
8192,1,64,8,16,1435,65,457354,176,459030
8192,2,32,8,16,1415,49,450644,178,452286
8192,2,32,8,16,1388,50,448298,170,449906
8192,2,32,8,16,1362,70,456927,185,458544
8192,2,32,8,16,1350,48,451684,179,453261
8192,2,32,8,16,1386,67,467649,213,469315
8192,2,32,8,16,1407,57,443422,175,445061
8192,2,32,8,16,1517,48,456964,211,458740
8192,2,32,8,16,1431,49,450499,177,452156
8192,2,32,8,16,1353,48,448666,174,450241
8192,2,32,8,16,1389,49,447922,225,449585
8192,4,16,8,16,1349,48,450517,176,452090
8192,4,16,8,16,1379,48,464679,176,466282
8192,4,16,8,16,1359,68,456953,176,458556
8192,4,16,8,16,1349,47,469574,253,471223
8192,4,16,8,16,1364,48,460005,182,461599
8192,4,16,8,16,1385,49,459249,240,460923
8192,4,16,8,16,1390,97,451320,180,452987
8192,4,16,8,16,1385,49,459862,319,461615
8192,4,16,8,16,1615,89,465211,255,467170
8192,4,16,8,16,1351,51,460660,249,462311
8192,8,8,8,16,1349,49,453136,187,454721
8192,8,8,8,16,1401,52,446792,221,448466
8192,8,8,8,16,1350,49,458792,180,460371
8192,8,8,8,16,1398,49,456526,190,458163
8192,8,8,8,16,1620,131,451346,199,453296
8192,8,8,8,16,2116,50,468549,184,470899
8192,8,8,8,16,1351,48,443988,174,445561
8192,8,8,8,16,1731,130,446848,181,448890
8192,8,8,8,16,1401,57,445590,176,447224
8192,8,8,8,16,1456,96,459192,178,460922
8192,16,4,8,16,1356,77,468228,250,469911
8192,16,4,8,16,1484,71,472459,182,474196
8192,16,4,8,16,1349,48,449463,175,451035
8192,16,4,8,16,1350,49,449150,179,450728
8192,16,4,8,16,1407,77,463492,247,465223
8192,16,4,8,16,1805,80,461679,199,463763
8192,16,4,8,16,1644,107,453413,173,455337
8192,16,4,8,16,1353,49,460690,194,462286
8192,16,4,8,16,1426,50,470698,181,472355
8192,16,4,8,16,1601,135,438115,210,440061
8192,32,2,8,16,1359,79,456269,176,457883
8192,32,2,8,16,1405,85,456498,178,458166
8192,32,2,8,16,1394,49,442026,194,443663
8192,32,2,8,16,1484,49,451621,177,453331
8192,32,2,8,16,1397,49,441302,217,442965
8192,32,2,8,16,1527,71,451429,212,453239
8192,32,2,8,16,1960,74,462948,203,465185
8192,32,2,8,16,1400,48,448684,174,450306
8192,32,2,8,16,1430,51,475691,187,477359
8192,32,2,8,16,1384,49,474337,321,476091
8192,64,1,8,16,1965,88,425532,179,427764
8192,64,1,8,16,1763,86,452877,178,454904
8192,64,1,8,16,1350,49,448044,177,449620
8192,64,1,8,16,1407,66,454721,175,456369
8192,64,1,8,16,1350,49,446791,214,448404
8192,64,1,8,16,1408,72,439728,174,441382
8192,64,1,8,16,1426,78,422746,180,424430
8192,64,1,8,16,1350,48,449077,173,450648
8192,64,1,8,16,1459,85,439490,241,441275
8192,64,1,8,16,1437,59,442895,273,444664
8192,1,128,8,8,1349,47,470455,198,472049
8192,1,128,8,8,1356,62,486846,179,488443
8192,1,128,8,8,1349,49,456046,208,457652
8192,1,128,8,8,1385,50,456197,173,457805
8192,1,128,8,8,1385,48,468401,182,470016
8192,1,128,8,8,1391,66,476557,228,478242
8192,1,128,8,8,1384,50,450450,174,452058
8192,1,128,8,8,2055,174,457885,199,460313
8192,1,128,8,8,1351,47,477553,221,479172
8192,1,128,8,8,1870,180,467440,221,469711
8192,2,64,8,8,1428,53,443952,266,445699
8192,2,64,8,8,1564,54,454203,177,455998
8192,2,64,8,8,1384,49,465292,173,466898
8192,2,64,8,8,1349,48,476208,187,477792
8192,2,64,8,8,1659,49,454092,171,455971
8192,2,64,8,8,1349,48,469291,191,470879
8192,2,64,8,8,1394,52,468887,176,470509
8192,2,64,8,8,1686,84,472540,183,474493
8192,2,64,8,8,1349,66,465026,179,466620
8192,2,64,8,8,1381,77,475052,176,476686
8192,4,32,8,8,1350,48,485039,179,486616
8192,4,32,8,8,1351,48,491274,197,492870
8192,4,32,8,8,1350,48,482627,179,484204
8192,4,32,8,8,1349,47,467563,178,469137
8192,4,32,8,8,1451,100,469387,208,471146
8192,4,32,8,8,1350,50,472204,177,473781
8192,4,32,8,8,1393,49,479669,177,481288
8192,4,32,8,8,1953,79,473664,177,475873
8192,4,32,8,8,1411,49,500835,178,502473
8192,4,32,8,8,1350,48,487313,203,488914
8192,8,16,8,8,1408,79,493986,171,495644
8192,8,16,8,8,1718,75,513832,190,515815
8192,8,16,8,8,1619,77,508671,178,510545
8192,8,16,8,8,1394,68,493709,178,495349
8192,8,16,8,8,1397,49,483141,187,484774
8192,8,16,8,8,1373,87,474613,174,476247
8192,8,16,8,8,1350,48,476985,260,478643
8192,8,16,8,8,2145,56,498161,181,500543
8192,8,16,8,8,1521,112,471681,187,473501
8192,8,16,8,8,1422,52,475372,261,477107
8192,16,8,8,8,1357,72,476202,229,477860
8192,16,8,8,8,1351,51,471415,194,473011
8192,16,8,8,8,1401,68,459507,184,461160
8192,16,8,8,8,1500,91,486531,210,488332
8192,16,8,8,8,2005,51,478934,182,481172
8192,16,8,8,8,1384,48,470258,219,471909
8192,16,8,8,8,1354,63,487190,180,488787
8192,16,8,8,8,1351,51,458448,221,460071
8192,16,8,8,8,1404,50,482646,230,484330
8192,16,8,8,8,1349,47,475790,179,477365
8192,32,4,8,8,1435,48,467551,180,469214
8192,32,4,8,8,1349,48,464949,181,466527
8192,32,4,8,8,1399,49,454091,235,455774
8192,32,4,8,8,1442,77,468009,224,469752
8192,32,4,8,8,1350,48,472421,177,473996
8192,32,4,8,8,1373,66,458594,179,460212
8192,32,4,8,8,2234,76,463805,180,466295
8192,32,4,8,8,1569,69,453884,184,455706
8192,32,4,8,8,1409,51,445982,175,447617
8192,32,4,8,8,1400,48,435876,348,437672
8192,64,2,8,8,1413,50,430359,181,432003
8192,64,2,8,8,1383,48,436435,181,438047
8192,64,2,8,8,1397,50,462752,213,464412
8192,64,2,8,8,1407,63,448562,209,450241
8192,64,2,8,8,1402,59,439295,190,440946
8192,64,2,8,8,1473,128,436344,191,438136
8192,64,2,8,8,1392,51,433194,177,434814
8192,64,2,8,8,1427,108,453278,175,454988
8192,64,2,8,8,1397,56,447984,173,449610
8192,64,2,8,8,1390,49,444713,197,446349
8192,128,1,8,8,1349,48,440638,183,442218
8192,128,1,8,8,1425,62,438252,185,439924
8192,128,1,8,8,1389,47,441375,207,443018
8192,128,1,8,8,1349,47,440702,183,442281
8192,128,1,8,8,1349,48,438617,175,440189
8192,128,1,8,8,1559,153,451105,225,453042
8192,128,1,8,8,1958,67,430328,199,432552
8192,128,1,8,8,1411,48,436221,400,438080
8192,128,1,8,8,1536,65,456415,185,458201
8192,128,1,8,8,1506,97,436211,222,438036
8192,1,256,4,8,1375,48,448950,174,450547
8192,1,256,4,8,1475,54,371632,198,373359
8192,1,256,4,8,1349,47,410310,212,411918
8192,1,256,4,8,1351,62,325994,1059,328466
8192,1,256,4,8,1912,74,394986,255,397227
8192,1,256,4,8,1412,49,432153,178,433792
8192,1,256,4,8,1349,55,325954,1005,328363
8192,1,256,4,8,1385,48,408246,203,409882
8192,1,256,4,8,1349,48,373531,212,375140
8192,1,256,4,8,1393,49,407713,220,409375
8192,2,128,4,8,1487,77,373417,2753,377734
8192,2,128,4,8,1623,99,425586,179,427487
8192,2,128,4,8,1349,47,429233,9496,440125
8192,2,128,4,8,2070,50,449761,217,452098
8192,2,128,4,8,1395,50,437013,216,438674
8192,2,128,4,8,1442,73,387288,168,388971
8192,2,128,4,8,1349,47,406491,201,408088
8192,2,128,4,8,1443,52,389895,176,391566
8192,2,128,4,8,1493,96,434138,232,435959
8192,2,128,4,8,1451,53,370244,174,371922
8192,4,64,4,8,1384,48,336406,249,338087
8192,4,64,4,8,1401,49,432771,176,434397
8192,4,64,4,8,1427,75,425405,194,427101
8192,4,64,4,8,1388,49,373939,234,375610
8192,4,64,4,8,1357,62,394489,246,396154
8192,4,64,4,8,1674,72,372057,178,373981
8192,4,64,4,8,1353,49,374309,339,376050
8192,4,64,4,8,1351,67,335296,204,336918
8192,4,64,4,8,1349,48,327065,251,328713
8192,4,64,4,8,1351,48,419880,173,421452
8192,8,32,4,8,1385,48,458763,260,460456
8192,8,32,4,8,1429,51,425405,175,427060
8192,8,32,4,8,1810,51,425219,264,427344
8192,8,32,4,8,1421,64,440144,184,441813
8192,8,32,4,8,1408,53,408925,379,410765
8192,8,32,4,8,2031,56,427461,298,429846
8192,8,32,4,8,1357,64,414683,187,416291
8192,8,32,4,8,1352,66,427063,182,428663
8192,8,32,4,8,1401,49,440485,196,442131
8192,8,32,4,8,1604,82,425065,180,426931
8192,16,16,4,8,1397,49,419734,218,421398
8192,16,16,4,8,1976,92,440835,169,443072
8192,16,16,4,8,1778,103,443549,176,445606
8192,16,16,4,8,2028,49,428068,220,430365
8192,16,16,4,8,1399,51,431936,228,433614
8192,16,16,4,8,1479,51,438009,179,439718
8192,16,16,4,8,1633,148,423927,174,425882
8192,16,16,4,8,1392,51,424307,262,426012
8192,16,16,4,8,1436,116,456262,262,458076
8192,16,16,4,8,2263,122,446131,172,448688
8192,32,8,4,8,1613,77,426496,173,428359
8192,32,8,4,8,1354,50,436504,243,438151
8192,32,8,4,8,1809,81,432082,195,434167
8192,32,8,4,8,1385,49,447028,329,448791
8192,32,8,4,8,1409,88,424453,190,426140
8192,32,8,4,8,1405,49,427279,256,428989
8192,32,8,4,8,1975,50,454216,182,456423
8192,32,8,4,8,1736,103,437249,204,439292
8192,32,8,4,8,1623,52,412533,175,414383
8192,32,8,4,8,1414,105,431609,352,433480
8192,64,4,4,8,1401,70,441961,410,443842
8192,64,4,4,8,2060,64,445840,203,448167
8192,64,4,4,8,1509,55,453883,180,455627
8192,64,4,4,8,1407,48,464032,1675,467162
8192,64,4,4,8,1384,50,438122,226,439782
8192,64,4,4,8,1384,47,441045,255,442731
8192,64,4,4,8,1566,60,444128,173,445927
8192,64,4,4,8,1667,119,469679,187,471652
8192,64,4,4,8,1436,60,446805,173,448474
8192,64,4,4,8,1793,70,443234,181,445278
8192,128,2,4,8,2081,54,442663,188,444986
8192,128,2,4,8,1354,60,410445,188,412047
8192,128,2,4,8,1448,49,430268,175,431940
8192,128,2,4,8,1405,86,380708,185,382384
8192,128,2,4,8,1349,48,401176,180,402753
8192,128,2,4,8,1619,75,405250,178,407122
8192,128,2,4,8,1350,75,422914,204,424543
8192,128,2,4,8,1396,51,428916,210,430573
8192,128,2,4,8,1351,49,402434,178,404012
8192,128,2,4,8,1353,68,452042,187,453650
8192,256,1,4,8,1634,89,402976,193,404892
8192,256,1,4,8,1624,81,470289,221,472215
8192,256,1,4,8,1418,49,431267,173,432907
8192,256,1,4,8,1437,67,432164,184,433852
8192,256,1,4,8,1394,49,431368,176,432987
8192,256,1,4,8,1391,70,397574,180,399215
8192,256,1,4,8,1350,50,327859,246,329505
8192,256,1,4,8,1957,94,433225,185,435461
8192,256,1,4,8,1549,98,388780,177,390604
8192,256,1,4,8,1617,50,444240,176,446083
